ॐ	Oṃ	phrase
अकम्पत	akampata	imperfect
अकर्तयत्	akartayat	imperfect
अकाशत्	akāśat	imperfect
अखथयत्	akhathayat	imperfect
अग्रिमं निस्थानं अस्माकं वा?	agrimaṃ nisthānaṃ asmākaṃ vā?	sent.
अग्रे	agre	loc.
अग्रे गच्छतु	agre gacchatu	sent.
अङ्कद्वयेन प्रथमश्रेणी न लब्धा	aṅkadvayena prathamaśreṇī na labdhā	sent.
अङ्कन्या मास्तु, लेखन्या लिखतु	aṅkanyā māstu, lekhanyā likhatu	sent.
अङ्कयतु	aṅkayatu	imperative
अचिरदर्शनाय	aciradarśanāya	sentence
अञ्चलः बहु सम्यक् अस्ति	añcalaḥ bahu samyak asti	sent.
अतिथ्यः आगताः सन्ति	atithyaḥ āgatāḥ santi	sent.
अतिपूष्टिर्बभूव	atipūṣṭirbabhūva	phrase
अतीव सुलभा आसीत्	atīva sulabhā āsīt	sent.
अत्र आगच्छ	atra āgaccha	sent.
अत्र आसनपरिग्रहं करोतु भवान्	atra āsanaparigrahaṃ karotu bhavān	sentence
अत्र उपविश	atra upaviśa	sent.
अत्र तस्य एव सर्वाधिकारः	atra tasya eva sarvādhikāraḥ	sent.
अत्र तिष्ठ	atra tiṣṭha	sentence
अत्र पत्रालयः कुत्र अस्ति?	atra patrālayaḥ kutra asti?	sent.
अत्र वायुः सुष्ठु वाति	atra vāyuḥ suṣṭhu vāti	sent.
अत्र विश्रामं कुरु	atra viśrāmaṃ kuru	sentence
अत्र हस्ताक्षरं स्थापयतु	atra hastākṣaraṃ sthāpayatu	sent.
अत्रैव कलाशालायां पठामि	atraiva kalāśālāyāṃ paṭhāmi	sent.
अत्रैव किञ्चित् कार्यं अस्ति	atraiva kiñcit kāryaṃ asti	sent.
अत्रैव कुत्रचित् स्यात्, अन्वेषणं कुर्मः	atraiva kutracit syāt, anveṣaṇaṃ kurmaḥ	sent.
अथ किम्?	atha kim?	expr.
अथ किम्?	atha kim?	sent.
अथ किम् ?	atha kim ?	sent.
अथवा	athavā	phrase
अद्य अपि सारः एव?	adya api sāraḥ eva?	sent.
अद्य अस्माकं कृते काफी अस्ति वा?	adya asmākaṃ kṛte kāphī asti vā?	sent.
अद्य आसीत् किम् ?	adya āsīt kim ?	sentence
अद्य आसीत् वा?	adya āsīt vā?	sent.
अद्य उत्थाने विलम्बः अभवत्	adya utthāne vilambaḥ abhavat	sent.
अद्य उत्थाने विलम्बः सञ्जातः	adya utthāne vilambaḥ sañjātaḥ	sent.
अद्य एतावदेव पर्याप्तम्	adya etāvadeva paryāptam	sent.
अद्य एव दातव्यं वा?	adya eva dātavyaṃ vā?	sent.
अद्य एव वा?	adya eva vā?	expr.
अद्य एव शुल्कं दातव्यं अस्ति	adya eva śulkaṃ dātavyaṃ asti	sent.
अद्य कक्ष्यां न स्वीकरोमि, इति सूचयतु	adya kakṣyāṃ na svīkaromi, iti sūcayatu	sent.
अद्य कतमा तिथिः ?	adya katamā tithiḥ ?	sentence
अद्य किञ्चित् उत्तमा (देहस्थितिः )	adya kiñcit uttamā (dehasthitiḥ )	sent.
अद्य किञ्चित्पूर्वं आगच्छन्ति वा?	adya kiñcitpūrvaṃ āgacchanti vā?	sent.
अद्य किञ्चित् शैत्यं अधिकम्	adya kiñcit śaityaṃ adhikam	sent.
अद्य किमपि न पठितवान् एव	adya kimapi na paṭhitavān eva	sent.
अद्य किम् करोति ?	adya kim karoti ?	sentence
अद्य कः पाकः?	adya kaḥ pākaḥ?	sent.
अद्य कः वारः ?	adya kaḥ vāraḥ ?	sentence
अद्य कः वासरः ?	adya kaḥ vāsaraḥ ?	sentence
अद्य ज्वरः कथं अस्ति?	adya jvaraḥ kathaṃ asti?	sent.
अद्यतन पत्रिकां ददातु	adyatana patrikāṃ dadātu	sent.
अद्यतन पाकः बहु सम्यक् अस्ति	adyatana pākaḥ bahu samyak asti	sent.
अद्य तिथिः द्वितीया	adya tithiḥ dvitīyā	sentence
अद्य तु विरामः	adya tu virāmaḥ	sent.
अद्य त्वम् कुत्र असि?	adya tvam kutra asi?	sent.
अद्य दिवा दशवादनात् चतुर्वादनपर्यन्तम्	adya divā daśavādanāt caturvādanaparyantam	phrase
अद्य निशि	adya niśi	phrase
अद्य प्रभाते	adya prabhāte	phrase
अद्य प्रभाते पञ्चवादने एकं चषकं काफीं एव पीतवान्	adya prabhāte pañcavādane ekaṃ caṣakaṃ kāphīṃ eva pītavān	sent.
अद्य प्रातराशः का?	adya prātarāśaḥ kā?	sent.
अद्य प्रातः आगतवती	adya prātaḥ āgatavatī	sentence
अद्य प्रातः आगतवान् वा?	adya prātaḥ āgatavān vā?	sent.
अद्य प्रातः आरभ्य बहु कार्याणि	adya prātaḥ ārabhya bahu kāryāṇi	sent.
अद्य भवतः कार्यक्रमः कः?	adya bhavataḥ kāryakramaḥ kaḥ?	sent.
अद्य भवतः मित्रं मार्गे मिलितः	adya bhavataḥ mitraṃ mārge militaḥ	sent.
अद्य भूरि भोजनम्	adya bhūri bhojanam	sent.
अद्य मधुरभक्ष्यं किम्?	adya madhurabhakṣyaṃ kim?	sent.
अद्य मध्याह्ने	adya madhyāhne	phrase
अद्य मांसं खादितव्यम्	adya māṃsaṃ khāditavyam	sent.
अद्य विरामः चेत् शरीराय न विरामः एव । अतः भवान् शीघ्रं गत्वा स्नानं करोतु कृपया	adya virāmaḥ cet śarīrāya na virāmaḥ eva | ataḥ bhavān śīghraṃ gatvā snānaṃ karotu kṛpayā	sent.
अद्य वृष्टिः भवति वा?	adya vṛṣṭiḥ bhavati vā?	sent.
अद्य शीघ्रम् आगच्छ	adya śīghram āgaccha	sentence
अद्य समग्रस्य गृहस्य मार्जनं मया करणीयम्	adya samagrasya gṛhasya mārjanaṃ mayā karaṇīyam	sent.
अद्य समवस्त्रेण गन्तव्यं वा?	adya samavastreṇa gantavyaṃ vā?	sent.
अद्य सायम्	adya sāyam	phrase
अद्य सोमवासरः	adya somavāsaraḥ	sent.
अद्य सः अत्र नास्ति किल	adya saḥ atra nāsti kila	sent.
अद्यैव गन्तव्यं वा?	adyaiva gantavyaṃ vā?	sent.
अधिकं जलं मा पिबतु, शीतं भवति	adhikaṃ jalaṃ mā pibatu, śītaṃ bhavati	sent.
अधिकं न ?	adhikaṃ na ?	sentence
अधिवेतनं लब्धं वा?	adhivetanaṃ labdhaṃ vā?	sent.
अधुना तु अतीव शीतलः	adhunā tu atīva śītalaḥ	sent.
अधः व्रजति	adhaḥ vrajati	sent.
अनुकल र च य	anukala ra ca ya	phrase
"अनुकल र च य , क से ख तक"	"anukala ra ca ya , ka se kha taka"	phrase
अनेन विधानेन	anena vidhānena	phrase
अनेन व्यञ्जनं करणीयं आसीत्	anena vyañjanaṃ karaṇīyaṃ āsīt	sent.
अन्तिमदिनाङ्कः कदा?	antimadināṅkaḥ kadā?	sent.
अन्तिम-समाचारः कः ?	antima-samācāraḥ kaḥ ?	sentence
अन्तं व्रजति	antaṃ vrajati	sent.
अन्तः आगच्छतु	antaḥ āgacchatu	sentence
अन्तः किम् अस्ति ?	antaḥ kim asti ?	sentence
अन्तः कोऽपि नास्ति वा?	antaḥ ko pi nāsti vā?	sent.
अन्ने केवलं पाषाणाः	anne kevalaṃ pāṣāṇāḥ	sent.
अन्नं तण्डुलतः आगच्छति	annaṃ taṇḍulataḥ āgacchati	sent.
अन्नं बहु उष्णम्	annaṃ bahu uṣṇam	sent.
अन्यच्च	anyacca	expr.
अन्यतः व्रजति	anyataḥ vrajati	sent.
अन्यत् कार्यं किमपि नास्ति	anyat kāryaṃ kimapi nāsti	sent.
अन्यत् किमपि कार्यम् नास्ति	anyat kimapi kāryam nāsti	sent.
अन्यत् किमपि नास्ति केवलं सारः	anyat kimapi nāsti kevalaṃ sāraḥ	sent.
अन्यत् किम् आवश्यकम् ?	anyat kim āvaśyakam ?	sent.
अन्यथा न चिन्तयतु	anyathā na cintayatu	sent.
अन्यथा बहु कष्टम्	anyathā bahu kaṣṭam	sent.
अन्यपार्श्वं गच्छ !	anyapārśvaṃ gaccha !	sentence
अन्यस्मिन् स्थाने	anyasmin sthāne	loc.
अन्या का ?	anyā kā ?	sentence
अन्येषां उपहासेनैव कालं यापयति	anyeṣāṃ upahāsenaiva kālaṃ yāpayati	sent.
अन्यं कः अपि न पृच्छतु	anyaṃ kaḥ api na pṛcchatu	sent.
अन्वेषणं पुनराधानं च	anveṣaṇaṃ punarādhānaṃ ca	phrase
अपघाते सः जीवितः इत्येव विशेषः	apaghāte saḥ jīvitaḥ ityeva viśeṣaḥ	sent.
अपरम् आनय !	aparam ānaya !	sent.
अपरं युतकं एवं नास्ति	aparaṃ yutakaṃ evaṃ nāsti	sent.
अपि अयं सुखी ?	api ayaṃ sukhī ?	sentence
अपि इदम् तदीयम्?	api idam tadīyam?	sentence
अपि इदम् नूतनम् घटी ?	api idam nūtanam ghaṭī ?	sent.
अपि इदम् पुस्तकम् मदीयम् न?	api idam pustakam madīyam na?	sentence
अपि इदं प्रसिद्धं सभागृहम्?	api idaṃ prasiddhaṃ sabhāgṛham?	sent.
अपि इदं मधुरम् ?	api idaṃ madhuram ?	sentence
अपि इमानि फलानि पक्वानि?	api imāni phalāni pakvāni?	sent.
अपि इमानै घटिकायन्त्रानि?	api imānai ghaṭikāyantrāni?	sent.
अपि इमी अविनीताः?	api imī avinītāḥ?	sent.
अपि इमी उत्तमः माणवकाः?	api imī uttamaḥ māṇavakāḥ?	sent.
अपि इयं न तव रत्नमाला?	api iyaṃ na tava ratnamālā?	sent.
अपि एषः नाम फलम् इच्छति?	api eṣaḥ nāma phalam icchati?	sent.
अपि कुशलम्?	api kuśalam?	sentence
अपि कुशली त्वम्?	api kuśalī tvam?	sent.
अपि तत् उष्णम् अस्ति ?	api tat uṣṇam asti ?	sentence
अपि तत् विशालम् ?	api tat viśālam ?	sentence
अपि ते सर्वे एकत्र एव सन्ति?	api te sarve ekatra eva santi?	sent.
अपि सत्यम् ?	api satyam ?	sentence
अपि सर्वं कुशलम् ?	api sarvaṃ kuśalam ?	sentence
अपि सः स्वस्थः ?	api saḥ svasthaḥ ?	sentence
अपूपम् अस्ति	apūpam asti	sent.
अपेहि !	apehi !	sent.
अप्रियवादिन्	apriyavādin	.a
अभिनन्दनम्	abhinandanam	phrase
अभ्यन्तरम् आगच्छ	abhyantaram āgaccha	sent.
अभ्यस्तम् एति	abhyastam eti	phrase
अमेरिकायुक्तप्रदेशाः	amerikāyuktapradeśāḥ	m.pl.
अम्ब, अत्र किञ्चित् परिवेषयतु	amba, atra kiñcit pariveṣayatu	sent.
अम्ब, अत्र किञ्चित् वेदना अस्ति	amba, atra kiñcit vedanā asti	sent.
अम्ब! अद्य कदा वा भोजनम्?	amba! adya kadā vā bhojanam?	sent.
अम्ब, एकं नवीनं युतकं आवश्यकम्	amba, ekaṃ navīnaṃ yutakaṃ āvaśyakam	sent.
अम्ब! किञ्चित् उपदंशं परिवेषयतु	amba! kiñcit upadaṃśaṃ pariveṣayatu	sent.
अम्ब, किञ्चित् सीवनं करोतु	amba, kiñcit sīvanaṃ karotu	sent.
अम्ब, तान् अन्यत्र पठितुं वदतु	amba, tān anyatra paṭhituṃ vadatu	sent.
अम्ब, बुभुक्षा भवति	amba, bubhukṣā bhavati	sent.
अम्ब, वेणीबन्धं करोतु, शालायाः विलम्बः भवति	amba, veṇībandhaṃ karotu, śālāyāḥ vilambaḥ bhavati	sent.
अये अत्र आगच्छतु!	aye atra āgacchatu!	sent.
अये, पादपथे आगच्छतु	aye, pādapathe āgacchatu	sent.
अयं कस्य अश्वः ?	ayaṃ kasya aśvaḥ ?	sent.
अयं न मम मार्जारः	ayaṃ na mama mārjāraḥ	sent.
अय्यो, घृतं एव न परिवेषितवती अहम्।	ayyo, ghṛtaṃ eva na pariveṣitavatī aham|	sent.
अय्यो! रक्तं स्रवति!	ayyo! raktaṃ sravati!	sent.
अरण्यम् क्रमणीयम् आसीत्	araṇyam kramaṇīyam āsīt	sent.
अरण्यं निकषा कुसुमानि रोहन्ति.	araṇyaṃ nikaṣā kusumāni rohanti.	sent.
अरे! दशवादनम्!	are! daśavādanam!	sent.
अरे! पादस्य / हस्तस्य किं अभवत्?	are! pādasya  /  hastasya kiṃ abhavat?	sent.
अर्चतु	arcatu	imperative
अर्जतु	arjatu	imperative
अर्थयताम्	arthayatām	imperative
अर्धक्रोशक-दुरे	ardhakrośaka-dure	phrase
अर्धघण्टाभ्यन्तरे आगच्छामि	ardhaghaṇṭābhyantare āgacchāmi	sent.
अर्ध-रात्र-वेलायाम्	ardha-rātra-velāyām	phrase
अर्धरात्रौ सिद्धार्थः जागरितः अभवत्	ardharātrau siddhārthaḥ jāgaritaḥ abhavat	sent.
अलम्	alam	sent.
अलम् क्रीडया	alam krīḍayā	sent.
अलम् विवादेन	alam vivādena	sent.
अलम् विस्तरेन	alam vistarena	sent.
अलं हसेन	alaṃ hasena	sent.
अवगतम् ?	avagatam ?	sent.
अवश्यम् एव	avaśyam eva	phrase
अवश्यं आगच्छामि	avaśyaṃ āgacchāmi	sent.
अवश्यं आगन्तव्यं, न विस्मर्तव्यम्	avaśyaṃ āgantavyaṃ, na vismartavyam	sent.
अवश्यं तत्रैव आगच्छामि	avaśyaṃ tatraiva āgacchāmi	sent.
अवश्यं मम गृहं आगन्तव्यम्	avaśyaṃ mama gṛhaṃ āgantavyam	sent.
अवश्यं सूचयामि	avaśyaṃ sūcayāmi	sent.
अवश्यं स्मृत्वा आनयन्तु	avaśyaṃ smṛtvā ānayantu	sent.
अवहितमनसा करणीयम्	avahitamanasā karaṇīyam	sent.
अविचक्षण	avicakṣaṇa	sent.
अशीति-भाग	aśīti-bhāga	phrase
अशेषदेशस्य अनेकेषु भागेषु घर्मादित्यं प्रवर्तति	aśeṣadeśasya anekeṣu bhāgeṣu gharmādityaṃ pravartati	sent.
अष्ट पर्णानि सन्ति	aṣṭa parṇāni santi	sent.
अष्टादश दश षडशीतिः	aṣṭādaśa daśa ṣaḍaśītiḥ	sent.
असम्बद्धं मा प्रलपतु	asambaddhaṃ mā pralapatu	sent.
असीमः आनन्दः	asīmaḥ ānandaḥ	phrase
अस्ति किल ?	asti kila ?	sent.
अस्तु	astu	sent.
अस्तु, एकक्षणं तिष्ठतु	astu, ekakṣaṇaṃ tiṣṭhatu	sent.
अस्तु, परिवेषणं करोमि	astu, pariveṣaṇaṃ karomi	sent.
अस्तु, परिशीलयामः	astu, pariśīlayāmaḥ	sent.
अस्तु , पिबामः	astu , pibāmaḥ	sent.
अस्तु, पुनः पश्यामः	astu, punaḥ paśyāmaḥ	sent.
अस्तु वा?	astu vā?	expr.
अस्तु, श्वः पुनः दूरवाणीं करोमि	astu, śvaḥ punaḥ dūravāṇīṃ karomi	sent.
अस्तु, स्वीकरोतु	astu, svīkarotu	sent.
अस्मत् गृहे एकैकस्य एकैका रुचिः	asmat gṛhe ekaikasya ekaikā ruciḥ	sent.
अस्माकम् देशः	asmākam deśaḥ	phrase
अस्माकं गणे सर्वेऽपि उत्तीर्णाः	asmākaṃ gaṇe sarve pi uttīrṇāḥ	sent.
अस्माकं गृहम्	asmākaṃ gṛham	phrase
अस्माकं गृहम् अस्मभ्यं निर्मितम्, न तु अन्येन	asmākaṃ gṛham asmabhyaṃ nirmitam, na tu anyena	sent.
अस्माकं गृहे सर्वे अस्वस्थाः	asmākaṃ gṛhe sarve asvasthāḥ	sent.
अस्माकं मिलनानन्तरं बहु कालः अतीतः	asmākaṃ milanānantaraṃ bahu kālaḥ atītaḥ	sent.
अस्मिन्	asmin	loc.
अस्मिन् एव प्रकरणे	asmin eva prakaraṇe	phrase
अस्मिन् जन्मनि	asmin janmani	phrase
अस्मिन् पक्षे	asmin pakṣe	phrase
अस्मिन् मार्गे	asmin mārge	phrase
अस्मिन् मासे	asmin māse	phrase
अस्मिन् मासे कति विरामः?	asmin māse kati virāmaḥ?	sent.
अस्मिन् वर्षे	asmin varṣe	phrase
अस्मिन् वर्षे फलितांशः कथम्?	asmin varṣe phalitāṃśaḥ katham?	sent.
अस्मिन् विषये अनन्तरं वदामि	asmin viṣaye anantaraṃ vadāmi	sent.
अस्मिन् विषये पुनः अपि चिन्तयामि	asmin viṣaye punaḥ api cintayāmi	sent.
अस्मिन् सप्ताहे	asmin saptāhe	phrase
अस्य अनुच्छेदस्य अन्ते समापयामः	asya anucchedasya ante samāpayāmaḥ	sent.
अस्य किं कारणम्?	asya kiṃ kāraṇam?	sent.
अस्य कः अर्थः ?	asya kaḥ arthaḥ ?	sent.
अस्य जतुलेपं कारयन्तु	asya jatulepaṃ kārayantu	sent.
अस्य द्वितकम् आनय!	asya dvitakam ānaya!	sent.
अस्य प्रकोष्ठस्य भाटकम्	asya prakoṣṭhasya bhāṭakam	phrase
अस्य प्रकोष्ठस्य वस्नः	asya prakoṣṭhasya vasnaḥ	phrase
अस्य प्रश्नस्य उत्तरम् ...	asya praśnasya uttaram ...	phrase
अस्य मूल्यम् एकं रूप्यकम्	asya mūlyam ekaṃ rūpyakam	sent.
अस्य मूल्यं कियत् ?	asya mūlyaṃ kiyat ?	sent.
अस्य रुचिं पश्यतु	asya ruciṃ paśyatu	sent.
अस्यां शताब्द्याम्	asyāṃ śatābdyām	phrase
अस्यां सहस्राब्द्याम्	asyāṃ sahasrābdyām	phrase
अस्याः नाम किम् ?	asyāḥ nāma kim ?	sent.
अस्याः शाटिकायाः अनुरूपः चोलः न लब्धः	asyāḥ śāṭikāyāḥ anurūpaḥ colaḥ na labdhaḥ	sent.
अस्वस्थः अपि आगतवान्	asvasthaḥ api āgatavān	sent.
अहमपि भवता सह आगच्छामि वा?	ahamapi bhavatā saha āgacchāmi vā?	sent.
अहमेव भवतीम् आह्वयितुम् शक्नोमि कृपया सूचयतु	ahameva bhavatīm āhvayitum śaknomi kṛpayā sūcayatu	sent.
अहम् अद्य अशोक वसतिगृहे अस्मि.	aham adya aśoka vasatigṛhe asmi.	sent.
अहम् अध्यापकः	aham adhyāpakaḥ	sent.
अहम् अध्यापिका अस्मि	aham adhyāpikā asmi	sent.
अहम् अपि एकां क्रेतुम् इच्छामि	aham api ekāṃ kretum icchāmi	sent.
अहम् अपि छात्रः	aham api chātraḥ	sent.
अहम् अष्टवादने प्रत्यागच्छामि	aham aṣṭavādane pratyāgacchāmi	sent.
अहम् अस्मि	aham asmi	sent.
अहम् आपणम् गच्छामि	aham āpaṇam gacchāmi	sent.
अहम् ईक्षे	aham īkṣe	sent.
अहम् उद्यानपर्यन्तम् अटामि	aham udyānaparyantam aṭāmi	sent.
अहम् कः ?	aham kaḥ ?	sent.
अहम् तां किमपि न वदामि । प्रयोजनम् किम् ?	aham tāṃ kimapi na vadāmi | prayojanam kim ?	sent.
अहम् न शक्नोमि	aham na śaknomi	sent.
अहम् पत्रम् अलिखम्	aham patram alikham	sent.
अहम् पुनः सूचयिष्यामि	aham punaḥ sūcayiṣyāmi	sent.
अहम् पुष्पम् अजिघ्रम्	aham puṣpam ajighram	sent.
अहम् मन्ये	aham manye	sent.
अहम् वृद्धः.	aham vṛddhaḥ.	sent.
अहम् शङ्के	aham śaṅke	sent.
अहम् सम्यक् अस्मि	aham samyak asmi	phrase
अहम् सायङ्काले अटामि	aham sāyaṅkāle aṭāmi	sent.
अहो	aho	phrase
अहो आपणात् बहिः एव छत्रं विस्मृतवती । इदानीम् एव दूरवाण्या आपनकः आहूतव्यः	aho āpaṇāt bahiḥ eva chatraṃ vismṛtavatī  | idānīm eva dūravāṇyā āpanakaḥ āhūtavyaḥ	sent.
अहो तत्तु सामान्यम्	aho tattu sāmānyam	sent.
अहो बत	aho bata	sent.
अहो! सा सर्वं दृष्टवती इत्येव मम मतः	aho! sā sarvaṃ dṛṣṭavatī ityeva mama mataḥ	sent.
अहो, सः तस्य भार्यायाः परः किम्?	aho, saḥ tasya bhāryāyāḥ paraḥ kim?	sent.
अहं अध्यापकः अस्मि	ahaṃ adhyāpakaḥ asmi	sent.
अहं अन्यद् उक्तवान्, भवान् अन्यद् गृहीतवान्	ahaṃ anyad uktavān, bhavān anyad gṛhītavān	sent.
अहं आगामिवर्षे करिष्यामि .	ahaṃ āgāmivarṣe kariṣyāmi .	sent.
अहं इदानीं एव आगतवान्	ahaṃ idānīṃ eva āgatavān	sent.
अहं कथं वदामि	ahaṃ kathaṃ vadāmi	sent.
अहं कलां पठामि	ahaṃ kalāṃ paṭhāmi	sent.
अहं कार्यव्यग्रः	ahaṃ kāryavyagraḥ	sent.
अहं कार्यालयं गच्छामि	ahaṃ kāryālayaṃ gacchāmi	sent.
अहं किमर्थं असत्यं वदामि?	ahaṃ kimarthaṃ asatyaṃ vadāmi?	sent.
अहं किं करोमि?	ahaṃ kiṃ karomi?	sent.
अहं किं करोमि भोः?	ahaṃ kiṃ karomi bhoḥ?	sent.
अहं कुशली / कुशलिनी अस्मि	ahaṃ kuśalī / kuśalinī asmi	sent.
अहं कृष्णः	ahaṃ kṛṣṇaḥ	sent.
अहं गन्तुं न शक्नोमि	ahaṃ gantuṃ na śaknomi	sent.
अहं गृहतः आगच्छामि	ahaṃ gṛhataḥ āgacchāmi	sent.
अहं गृहे एव त्यक्त्वा आगतवान्	ahaṃ gṛhe eva tyaktvā āgatavān	sent.
अहं चत्वारि पत्राणि प्रेषितवान् किन्तु उत्तरम् एकम् अपि न आगतम्	ahaṃ catvāri patrāṇi preṣitavān kintu uttaram ekam api na āgatam	sent.
अहं चित्रम् अपश्यम्	ahaṃ citram apaśyam	sent.
अहं जैनः । सूर्यास्तमनानन्तरम् अहं न खादामि	ahaṃ jainaḥ | sūryāstamanānantaram ahaṃ na khādāmi	sent.
अहं तद्दिने वर्गं न आगतवान् आसम्	ahaṃ taddine vargaṃ na āgatavān āsam	sent.
अहं तावदपि न जानामि वा?	ahaṃ tāvadapi na jānāmi vā?	sent.
अहं तुष्टः अस्मि	ahaṃ tuṣṭaḥ asmi	sent.
अहं त्वां नमस्कारोमि	ahaṃ tvāṃ namaskāromi	sent.
अहं दशवादने प्रत्यागच्छामि	ahaṃ daśavādane pratyāgacchāmi	sent.
अहं न जानामि	ahaṃ na jānāmi	sent.
अहं न जानामि, अन्यं पृच्छतु	ahaṃ na jānāmi, anyaṃ pṛcchatu	sent.
अहं निमेषद्वयस्य अनन्तरं चायकषायं शोधन्या शोधितवान्	ahaṃ nimeṣadvayasya anantaraṃ cāyakaṣāyaṃ śodhanyā śodhitavān	sent.
अहं नूतनशाटिकां क्रीतवती	ahaṃ nūtanaśāṭikāṃ krītavatī	sent.
अहं पञ्चम कक्ष्यायां पठामि	ahaṃ pañcama kakṣyāyāṃ paṭhāmi	sent.
अहं पादाभ्यां गच्छामि	ahaṃ pādābhyāṃ gacchāmi	sent.
अहं पुनः सूचयामि	ahaṃ  punaḥ sūcayāmi	sent.
अहं पृच्छामि चेत् सः उत्थास्यति	ahaṃ pṛcchāmi cet saḥ utthāsyati	sent.
अहं प्रथमश्रेण्यां उत्तीर्णः	ahaṃ prathamaśreṇyāṃ uttīrṇaḥ	sent.
अहं प्रातः इडलीं खादामि	ahaṃ prātaḥ iḍalīṃ khādāmi	sent.
अहं भवतः पार्श्वे उपविशामि	ahaṃ bhavataḥ pārśve upaviśāmi	sent.
अहं मातृगृहं गतवती	ahaṃ mātṛgṛhaṃ gatavatī	sent.
अहं यन्त्राकारे कार्यं करोमि	ahaṃ yantrākāre kāryaṃ karomi	sent.
अहं यात्रपत्रं क्रीणामि	ahaṃ yātrapatraṃ krīṇāmi	sent.
अहं रामः.	ahaṃ rāmaḥ.	sent.
अहं रोटिकां न खादामि	ahaṃ roṭikāṃ na khādāmi	sent.
अहं वाणिज्यशास्त्रं पठामि.	ahaṃ vāṇijyaśāstraṃ paṭhāmi.	sent.
अहं विज्ञानं पठामि	ahaṃ vijñānaṃ paṭhāmi	sent.
अहं विपणिं गच्छामि	ahaṃ vipaṇiṃ gacchāmi	sent.
अहं विषयम् अस्मरम्	ahaṃ viṣayam asmaram	sent.
अहं विस्मृतवान्, क्षम्यताम्	ahaṃ vismṛtavān, kṣamyatām	sent.
अहं शालातः, गृहतः, आगच्छामि	ahaṃ śālātaḥ, gṛhataḥ, āgacchāmi	sent.
अहं शीघ्रं प्रत्यागमिष्यामि	ahaṃ śīghraṃ pratyāgamiṣyāmi	sent.
अहं षिकागो-नगरस्य निवासि	ahaṃ ṣikāgo-nagarasya nivāsi	sent.
अहं सप्तवादने प्रतिदिनं कार्यालयात् आगछ्छामि	ahaṃ saptavādane pratidinaṃ kāryālayāt āgachchāmi	sent.
अहं सम्यक् न जानामि	ahaṃ samyak na jānāmi	sent.
अहं सर्वं व्यवस्थितं स्थापयितुं, सः व्यस्तं कर्तुम्	ahaṃ sarvaṃ vyavasthitaṃ sthāpayituṃ, saḥ vyastaṃ kartum	sent.
आकाशवाणीं चालयतु	ākāśavāṇīṃ cālayatu	sent.
आकाशवाणीं योजयतु	ākāśavāṇīṃ yojayatu	sent.
आकाशं पश्य	ākāśaṃ paśya	phrase
आगच्छ	āgaccha	sent.
आगच्छ !	āgaccha !	sent.
आगच्छति खलु ?	āgacchati khalu ?	sent.
आगच्छतु	āgacchatu	sent.
आगच्छतु, किञ्चित् काफीं पिबामः	āgacchatu, kiñcit kāphīṃ pibāmaḥ	sent.
आगच्छतु भोः, क्रीडामः	āgacchatu bhoḥ, krīḍāmaḥ	sent.
आगच्छतु भोः, गृहं गच्छामः	āgacchatu bhoḥ, gṛhaṃ gacchāmaḥ	sent.
आगच्छन्तु	āgacchantu	sent.
आगच्छामि	āgacchāmi	phrase
आगन्तव्यं भोः	āgantavyaṃ bhoḥ	sent.
आगामिअपराह्णे	āgāmiaparāhṇe	phrase
आगामि-चतुर्दश्याम्	āgāmi-caturdaśyām	phrase
आगामि-जन्मनि	āgāmi-janmani	phrase
आगामि-दुर्गापूजायाम्	āgāmi-durgāpūjāyām	phrase
आगामि-पूर्णिमायाम्	āgāmi-pūrṇimāyām	phrase
आगामि-प्रभातए	āgāmi-prabhātae	phrase
आगामि-मासे	āgāmi-māse	phrase
आगामि रविवासरे अहं क्रीडिष्यामि	āgāmi ravivāsare ahaṃ krīḍiṣyāmi	sent.
आगामि-रात्रौ	āgāmi-rātrau	phrase
आगामि-वर्षे	āgāmi-varṣe	phrase
आगामि-शताब्द्याम्	āgāmi-śatābdyām	phrase
आगामि-सप्ताहे	āgāmi-saptāhe	phrase
आगामिसप्ताहे गमिष्यामि	āgāmisaptāhe gamiṣyāmi	sent.
आगामि सप्ताहे मां पश्यतु	āgāmi saptāhe māṃ paśyatu	sent.
आगामि-सहस्राब्द्याम्	āgāmi-sahasrābdyām	phrase
आगामि-सोमवारे	āgāmi-somavāre	phrase
आङ्कयत्	āṅkayat	imperfect
आटत्	āṭat	imperfect
आत्मना-त्रितीय	ātmanā-tritīya	phrase
आत्मना-द्वितीय	ātmanā-dvitīya	phrase
आत्मना निर्वोढव्यानि महाकार्याणि कानि सन्ति इति किं भवान् विस्मृतवान् ?	ātmanā nirvoḍhavyāni mahākāryāṇi kāni santi iti kiṃ bhavān vismṛtavān ?	sent.
आत्मानं विद्धि	ātmānaṃ viddhi	sent.
आददि	ādadi	a.
आनय !	ānaya !	sent.
आपणतः आनीतानि सस्यानि कुत्र आरोपयामि ?	āpaṇataḥ ānītāni sasyāni kutra āropayāmi ?	sent.
आप्नोत्	āpnot	imperfect
आम् , अयं प्रकोष्ठः मदीयः	ām , ayaṃ prakoṣṭhaḥ madīyaḥ	sent.
आम्, अहम् कुशली.	ām, aham kuśalī.	sentence
आम्, इदम् अधिकं प्रसिद्धम्	ām, idam adhikaṃ prasiddham	sent.
आम्, इदम् बहु प्रसिद्धम्	ām, idam bahu prasiddham	sent.
आम् , इदं कीदृशम् ?	ām , idaṃ kīdṛśam ?	sent.
"आम् , कुशलम् अस्मि."	"ām , kuśalam asmi."	sent.
आम्, गोपालःअ मम सहाध्यायी.	ām, gopālaḥa mama sahādhyāyī.	sent.
आम्, तत् सत्यम्	ām, tat satyam	expr.
आम् तानि आनीय भवत्याः कपाटिकायां स्थापितवान्	ām tāni ānīya bhavatyāḥ kapāṭikāyāṃ sthāpitavān	sent.
आम्, तानि फलानि पक्वानि.	ām, tāni phalāni pakvāni.	sent.
आम् वयं चेम्स्फोर्द् नगरे अमरिका-देशे वसामः न तु आङ्लदेशे	ām vayaṃ cemsphord nagare amarikā-deśe vasāmaḥ na tu āṅladeśe	sent.
आम् , सर्वे कुशलिनः	ām , sarve kuśalinaḥ	sentence
आम्, सर्वं कुशलम्	ām, sarvaṃ kuśalam	sent.
आरक्षणं नास्ति	ārakṣaṇaṃ nāsti	sent.
आरात्रि वृष्टिः आसीत्	ārātri vṛṣṭiḥ āsīt	sent.
आरोग्यार्थं प्रतिदिनं प्रातः किञ्चित् कालम् आतपे तिष्टतु	ārogyārthaṃ pratidinaṃ prātaḥ kiñcit kālam ātape tiṣṭatu	sent.
आरोग्यं तावत् सम्यक् नास्ति	ārogyaṃ tāvat samyak nāsti	sent.
आरोग्यं त्वरितं भूयात्	ārogyaṃ tvaritaṃ bhūyāt	sent.
आरोग्यं निर्लक्ष्य मा पठतु	ārogyaṃ nirlakṣya mā paṭhatu	sent.
आर्चत्	ārcat	imperfect
आर्च्छत्	ārcchat	imperfect
आर्जत्	ārjat	imperfect
आर्थयत्	ārthayat	imperfect
आर्द्रवस्त्रं न धारयतु	ārdravastraṃ na dhārayatu	sent.
आर्य, भवान् कथम् अस्ति?	ārya, bhavān katham asti?	sent.
आर्ये, भवती कथम् अस्ति?	ārye, bhavatī katham asti?	sent.
आलम्बिन्	ālambin	suffix
आलसः तम् अनिन्दत्	ālasaḥ tam anindat	sent.
आलस्यात् कालं क्षिपति	ālasyāt kālaṃ kṣipati	expr.
आवश्यकं आसीत्, परन्तु भवान् मूल्यं अधिकं वदति	āvaśyakaṃ āsīt, parantu bhavān mūlyaṃ adhikaṃ vadati	sent.
आवश्यकं चेत् श्वः आनयामि	āvaśyakaṃ cet śvaḥ ānayāmi	sent.
आवश्यकं नासीत्	āvaśyakaṃ nāsīt	expr.
आशां धरामि	āśāṃ dharāmi	phrase
आसनपट्टीं बधान	āsanapaṭṭīṃ badhāna	sent.
आसन्दस्य चत्वारः पादाः सन्ति	āsandasya catvāraḥ pādāḥ santi	sent.
आं भोः	āṃ bhoḥ	sent.
इच्छतु	icchatu	imperative
इड्ली न लभ्यते	iḍlī na labhyate	sent.
इति प्रतिभाति	iti pratibhāti	sent.
इति प्रतिभाति मे मनसि	iti pratibhāti me manasi	sent.
इति साधुः	iti sādhuḥ	sent.
इतोऽपि यथेष्टं समयः अस्ति	ito pi yatheṣṭaṃ samayaḥ asti	sent.
इतोऽपि समयः अस्ति किल?	ito pi samayaḥ asti kila?	sent.
इतः आगच्छ	itaḥ āgaccha	sent.
इतः केवलं दशनिमेषाणां गमनम्	itaḥ kevalaṃ daśanimeṣāṇāṃ gamanam	sent.
इतः गच्छतु	itaḥ gacchatu	sent.
इतः परं एवं न कर्तव्यम्	itaḥ paraṃ evaṃ na kartavyam	sent.
इदमिदानीं भोजनं समाप्तम्	idamidānīṃ bhojanaṃ samāptam	sent.
इदम् अतीव अधिकम्	idam atīva adhikam	sent.
इदम् आसनम्	idam āsanam	phrase
इदम् आसनम् अलङ्करोतु भवान्	idam āsanam alaṅkarotu bhavān	sent
इदम् क्षीरम्	idam kṣīram	sent.
इदम् गृहम् तदीयम्	idam gṛham tadīyam	sentence
इदम् गृहं सुन्दरम्	idam gṛhaṃ sundaram	sent.
इदम् घटिकायन्त्रम् पुरातनम् किम्?	idam ghaṭikāyantram purātanam kim?	sent.
इदम् घटिकायन्त्रं पुरातनम्	idam ghaṭikāyantraṃ purātanam	sent.
इदम् न मदीयम्	idam na madīyam	sentence
इदम् फलं मधुरम्	idam phalaṃ madhuram	sent.
इदम् मम नास्ति	idam mama nāsti	sent.
इदम् लेखनी तदीया.	idam lekhanī tadīyā.	sentence
इदम् वस्त्रम् न मदीयम्	idam vastram na madīyam	sentence
इदानीन्तन बालास्तु!	idānīntana bālāstu!	sent.
इदानीमेव प्राप्तवान्	idānīmeva prāptavān	sent.
इदानीम् अपि निद्रा न आगता वा?	idānīm api nidrā na āgatā vā?	sent.
इदानीम् अपि स्नानं न कृतम्?	idānīm api snānaṃ na kṛtam?	sent.
इदानीम् भवान् इत्थं वदति किम् ?	idānīm bhavān itthaṃ vadati kim ?	sent.
इदानीं आगन्तुं न शक्यते	idānīṃ āgantuṃ na śakyate	sent.
इदानीं एव एकं यानं गतम्	idānīṃ eva ekaṃ yānaṃ gatam	sent.
इदानीं एव वा?	idānīṃ eva vā?	sent.
इदानीं कक्ष्या अस्ति वा?	idānīṃ kakṣyā asti vā?	sent.
इदानीं किम् ?	idānīṃ kim ?	sent.
इदानीं किम् कुर्मः ?	idānīṃ kim kurmaḥ ?	sent.
इदानीं कुत्र उद्योगः?	idānīṃ kutra udyogaḥ?	sent.
इदानीं कुत्र वासः?	idānīṃ kutra vāsaḥ?	sent.
इदानीं गत्वा किञ्चित् पठतु	idānīṃ gatvā kiñcit paṭhatu	sent.
इदानीं दशाधिक-नववादनम् अभवत्	idānīṃ daśādhika-navavādanam abhavat	sent.
इदानीं भवतः समयावकाशः अस्ति वा?	idānīṃ bhavataḥ samayāvakāśaḥ asti vā?	sent.
इदानीं मया अपि अन्यत्र गन्तव्यम्	idānīṃ mayā api anyatra gantavyam	sent.
इदानीं मया त्वरणीयम्	idānīṃ mayā tvaraṇīyam	sent.
इदानीं मास्तु, अनन्तरं आगच्छामि	idānīṃ māstu, anantaraṃ āgacchāmi	sent.
इदानीं मास्तु, अनन्तरं ददामि	idānīṃ māstu, anantaraṃ dadāmi	sent.
इदानीं यथार्थः समयः कः?	idānīṃ yathārthaḥ samayaḥ kaḥ?	sent.
इदानीं वा, समयः नास्ति भोः	idānīṃ vā, samayaḥ nāsti bhoḥ	sent.
इदानीं सप्तवादनम् । तां जागरयतु	idānīṃ saptavādanam | tāṃ jāgarayatu	sent.
इदानीं समयः अतीतः	idānīṃ samayaḥ atītaḥ	sent.
इदानीं सर्वत्र समाना किल?	idānīṃ sarvatra samānā kila?	sent.
इदं पुस्तकं पटले स्थापय	idaṃ pustakaṃ paṭale sthāpaya	sent.
इदं फलम् मदीयम्	idaṃ phalam madīyam	sent.
इदं भोजनं न स्पृश्यमानम्	idaṃ bhojanaṃ na spṛśyamānam	sent.
इदं मम नूतनं वाहनम्	idaṃ mama nūtanaṃ vāhanam	sent.
इमानि अपि पुरातनानि.	imāni api purātanāni.	sent.
इमानि कानि?	imāni kāni?	sent.
इमानि पीठानिपुरातनानि किम्?	imāni pīṭhānipurātanāni kim?	sent.
इमां कुत्र क्रीतवती?	imāṃ kutra krītavatī?	sent.
इमां सूचनाफलके स्थापयतु	imāṃ sūcanāphalake sthāpayatu	sent.
इमी उत्तमाः माणवकाः न.	imī uttamāḥ māṇavakāḥ na.	sent.
इमे बालकाः अस्माकम् माणवकाः.	ime bālakāḥ asmākam māṇavakāḥ.	sent.
इमौ द्वौ अपि मम छात्रौ.	imau dvau api mama chātrau.	sent.
इमं पार्श्वम् आगच्छ	imaṃ pārśvam āgaccha	sent.
इयं बृहती भोजनशाला	iyaṃ bṛhatī bhojanaśālā	sent.
इयं मम भगिनी	iyaṃ mama bhaginī	sentence
इयं माला न मदीया	iyaṃ mālā na madīyā	sent.
इयं लेखनी कस्य?	iyaṃ lekhanī kasya?	sent.
इयं लेखनी कस्याः?	iyaṃ lekhanī kasyāḥ?	sent.
इयं लेखनी मदीया	iyaṃ lekhanī madīyā	sent.
उक्तं एव वदति सः	uktaṃ eva vadati saḥ	sent.
उक्तं न श्रुतवान् वा?	uktaṃ na śrutavān vā?	sent.
उच्चत्या उभावपि समानौ	uccatyā ubhāvapi samānau	sent.
उच्छैर्वद	ucchairvada	sent.
उत्तमम् आसीत्	uttamam āsīt	sent.
उत्तमः कल्पः	uttamaḥ kalpaḥ	phrase
उत्तमः कल्पः.	uttamaḥ kalpaḥ.	sent.
उत्तररामचरिते भवभूतिः विशिष्यते	uttararāmacarite bhavabhūtiḥ viśiṣyate	sent.
उत्तरं लेखिष्यामि इति उक्तवान् परन्तु अद्य पर्यन्तं किमपि नास्ति	uttaraṃ lekhiṣyāmi iti uktavān parantu adya paryantaṃ kimapi nāsti	sent.
उत्तिष्ठतु, भोजनं कुर्मः	uttiṣṭhatu, bhojanaṃ kurmaḥ	sent.
उत्पीठिकायाः उपरि स्थापयतु, पितामहः अनन्तरम् पास्यति	utpīṭhikāyāḥ upari sthāpayatu, pitāmahaḥ anantaram pāsyati	sent.
उत्साहः एव नास्ति भोः	utsāhaḥ eva nāsti bhoḥ	sent.
उपरि उपविश्य पाठं पठिष्यामि इति वदति	upari upaviśya pāṭhaṃ paṭhiṣyāmi iti vadati	sent.
उपविश	upaviśa	sent.
उपविशन्तु	upaviśantu	expr.
उपानद्भ्यां व्रजति	upānadbhyāṃ vrajati	sent.
उष्णवस्त्रं धारय	uṣṇavastraṃ dhāraya	sent.
ऋच्छतु	ṛcchatu	imperative
एकता तथा भिन्नता	ekatā tathā bhinnatā	phrase
एकदेशं गच्छ	ekadeśaṃ gaccha	sent.
एकपञ्चाशत् रुप्यकाणि स्वीकुर्वन्तु	ekapañcāśat rupyakāṇi  svīkurvantu	sent.
एकमपि चित्रं सम्यक् नास्ति	ekamapi citraṃ samyak nāsti	sent.
एकम् सत्, विप्राः बहुधा वदन्ति	ekam sat, viprāḥ bahudhā vadanti	sent.
एकवारं एव सर्वं वदतु भवती	ekavāraṃ eva sarvaṃ vadatu bhavatī	sent.
एकाकिनी गतवती किम् ?	ekākinī gatavatī kim ?	sent.
एकाकिनी न गच्छतु	ekākinī na gacchatu	sent.
एकाकी किमर्थम्? परिवारसमेतः गतवान्	ekākī kimartham? parivārasametaḥ gatavān	sent.
एकाकी गतवान् वा?	ekākī gatavān vā?	sent.
एकान्ते	ekānte	loc.
एकैकशः वदतु नाम	ekaikaśaḥ vadatu nāma	sent.
एकैकस्य पञ्चविंशतिपैसाः	ekaikasya pañcaviṃśatipaisāḥ	sent.
एकोऽपि न जानाति वा?	eko pi na jānāti vā?	sent.
एकं अपि गणितं न कृतवान् वा ?	ekaṃ api gaṇitaṃ na kṛtavān vā ?	sent.
एकं अपि यानं न आगतम्	ekaṃ api yānaṃ na āgatam	sent.
एकं आसन्दं आनयतु	ekaṃ āsandaṃ ānayatu	sent.
एकं कार्यं कतिवारं वक्तव्यम्?	ekaṃ kāryaṃ kativāraṃ vaktavyam?	sent.
एकं पत्रं अवशिष्टं इति उक्तवान्	ekaṃ patraṃ avaśiṣṭaṃ iti uktavān	sent.
एकः निमेषः विलम्बः चेत् अहं गच्छामि स्म	ekaḥ nimeṣaḥ vilambaḥ cet ahaṃ gacchāmi sma	sent.
एकः व्र्द्धः आसीत्	ekaḥ vrddhaḥ āsīt	sent.
एतत् अधुनैव कुरु	etat adhunaiva kuru	sent.
एतत् अस्माकं धनं न	etat asmākaṃ dhanaṃ na	sent.
एतत् अहं अवश्यं स्मरामि	etat ahaṃ avaśyaṃ smarāmi	sent.
एतत् औषधं प्रतिदिनं त्रिवारं भवता पातव्यम् । दिनद्वयस्य अनन्तरं ज्वरः गमिष्यति निश्चयेन ।	etat auṣadhaṃ pratidinaṃ trivāraṃ bhavatā pātavyam | dinadvayasya anantaraṃ jvaraḥ gamiṣyati niścayena |	sent.
एतत् कस्मै दादव्यं मया?	etat kasmai dādavyaṃ mayā?	sent.
एतत् तत्र कुरु	etat tatra kuru	sent.
एतत् तस्मै देहि	etat tasmai dehi	sent.
एतत् न साधु	etat na sādhu	sent.
एतत् पुष्पसस्यं केवलं किञ्चित् जलेन प्रतिदिनं सेचनीयम्	etat puṣpasasyaṃ kevalaṃ kiñcit jalena pratidinaṃ secanīyam	sent.
एतत् सत्यम् खलु ?	etat satyam khalu ?	sent.
एतत् सत्यं किल?	etat satyaṃ kila?	sent.
एतत् सर्वं तव	etat sarvaṃ tava	sent.
एतदृशी कन्या न मिलेत् एव	etadṛśī kanyā na milet eva	sent.
एतद् कष्टं न	etad kaṣṭaṃ na	sent.
एतद् किञ्चित्कालं गृह्णातु	etad kiñcitkālaṃ gṛhṇātu	sent.
एतद् द्वितीयवारं पश्यन् अस्मि	etad dvitīyavāraṃ paśyan asmi	sent.
एतद् धनं मदीयम् अस्ति	etad dhanaṃ madīyam asti	sent.
एतद् पुस्तकं नास्ति वा?	etad pustakaṃ nāsti vā?	sent.
एतद् मह्यम् अतीव रोचते.	etad mahyam atīva rocate.	sent.
एतद् युतकं बहु सम्पृक्तम्	etad yutakaṃ bahu sampṛktam	sent.
एतद् वस्त्रं कुत्र क्रीतवन्तः?	etad vastraṃ kutra krītavantaḥ?	sent.
एतद्विषये श्वः पुनरपि स्मारयतु	etadviṣaye śvaḥ punarapi smārayatu	sent.
एतद् समीचीनं अस्ति वा?	etad samīcīnaṃ asti vā?	sent.
एतस्मिन् अन्तर	etasmin antara	phrase
एतस्य किं कारणम् ?	etasya kiṃ kāraṇam ?	sent.
एतस्य मूल्यं किम् ?	etasya mūlyaṃ kim ?	sent.
एतादृशी शाटिका मम समीपे अपि अस्ति	etādṛśī śāṭikā mama samīpe api asti	sent.
एतावत् अपि कृतवान्!	etāvat api kṛtavān!	sent.
एतावत् एव?	etāvat eva?	sent.
एतावत् धनं न पर्याप्तम्	etāvat dhanaṃ na paryāptam	sent.
एतावत् न्यूनमूल्येन अन्यत्र कुत्रापि न मिलति	etāvat nyūnamūlyena anyatra kutrāpi na milati	sent.
एतावत्पर्यन्तं कुत्र गतवान्?	etāvatparyantaṃ kutra gatavān?	sent.
एतावदेव ?	etāvadeva ?	sent.
एतावन्तः अङ्काः कथं लब्धाः ?	etāvantaḥ aṅkāḥ kathaṃ labdhāḥ ?	sent.
एतासु यानपेटिकासु किम् अस्ति ? उद्घाटनं कृत्वा दर्षयतु । शिघ्रम्	etāsu yānapeṭikāsu kim asti ? udghāṭanaṃ kṛtvā darṣayatu | śighram	sent.
एतां कादम्बरीं पठितवान् वा?	etāṃ kādambarīṃ paṭhitavān vā?	sent.
एतां वार्तां श्रुतवती किम् ?	etāṃ vārtāṃ śrutavatī kim ?	sent.
एते अक्रीडन्	ete akrīḍan	sent.
एतेषां विषये श्रुतवान्	eteṣāṃ viṣaye śrutavān	sent.
एतं स्यूतं मात्रे ददातु	etaṃ syūtaṃ mātre dadātu	sent.
एवमपि अस्ति वा?	evamapi asti vā?	expr.
एवमेव	evameva	expr.
एवमेव अग्रे गच्छन्तु	evameva agre gacchantu	sent.
एवमेव आगतवान्	evameva āgatavān	sent.
एवम् ?	evam ?	sent.
एवम् अस्तु	evam astu	sent.
एवं चेत् कथम्?	evaṃ cet katham?	sent.
एवं चेत् कथं जीवामः?	evaṃ cet kathaṃ jīvāmaḥ?	sent.
एवं चेत् परीक्षायां किं करोति?	evaṃ cet parīkṣāyāṃ kiṃ karoti?	sent.
एवं तर्हि	evaṃ tarhi	phrase
एवं भवति कदाचित्	evaṃ bhavati kadācit	sent.
एवं भवतु	evaṃ bhavatu	sent.
एवं भवितुं अर्हति	evaṃ bhavituṃ  arhati	sent.
एषा केवलं किंवदन्ती	eṣā kevalaṃ kiṃvadantī	sent.
एषा मम सखी	eṣā mama sakhī	sent.
एषा वार्ता मम कर्णमपि आगता	eṣā vārtā mama karṇamapi āgatā	sent.
एषा विश्वासं न करोति	eṣā viśvāsaṃ na karoti	sent.
एषा षट् शून्य शून्य शून्य चत्वारि वा?	eṣā ṣaṭ śūnya śūnya śūnya catvāri vā?	sent.
एषु दिनेषु महान् कार्यभारः	eṣu dineṣu mahān kāryabhāraḥ	sent.
एषु दिनेषु विमला मिलितवती वा?	eṣu dineṣu vimalā militavatī vā?	sent.
एषः एकः शनिः	eṣaḥ ekaḥ śaniḥ	sent.
एषः भवतः अपराधः न	eṣaḥ bhavataḥ aparādhaḥ na	sent.
एषः मम आदेशः	eṣaḥ mama ādeśaḥ	sent.
एषः मम गृहसङ्केतः	eṣaḥ mama gṛhasaṅketaḥ	sent.
एषः मम प्रथमः पाठः	eṣaḥ mama prathamaḥ pāṭhaḥ	sent.
एषः मम मित्रम्	eṣaḥ mama mitram	sent.
एषः मार्गः कुत्र गच्छति?	eṣaḥ mārgaḥ kutra gacchati?	sent.
एषः सङ्केतः कुत्र इति जानाति वा?	eṣaḥ saṅketaḥ kutra iti jānāti vā?	sent.
एषः सर्वदा आगत्य मां पीडयति	eṣaḥ sarvadā āgatya māṃ pīḍayati	sent.
ऐच्छत्	aicchat	imperfect
ओहो! तथा वा?	oho! tathā vā?	expr.
ओहो, मम अपेक्षया कनिष्ठः वा?	oho, mama apekṣayā kaniṣṭhaḥ vā?	sent.
क ऊन ख्	ka ūna kh	phrase
क ऋण ख	ka ṛṇa kha	phrase
क गुणित ख	ka guṇita kha	phrase
कटुयुक्तं खाद्यं सा न इच्छति एव	kaṭuyuktaṃ khādyaṃ sā na icchati eva	sent.
कटं प्रसारयतु	kaṭaṃ prasārayatu	sent.
कतमा त्वदीया लेखनी?	katamā tvadīyā lekhanī?	sent.
कति	kati	sent.
कति अपेक्षितानि?	kati apekṣitāni?	sent.
कति / कियत् ददामि?	kati / kiyat dadāmi?	sent.
कति छात्राः ?	kati chātrāḥ ?	sent.
कति दिनानाम्?	kati dinānām?	sent.
कति दिनानि	kati dināni	sent.
कति दिनानि ?	kati dināni ?	sent.
कतिपयेषु दिनेषु	katipayeṣu dineṣu	phrase
कति वादने ?	kati vādane ?	sent.
कतिवारं उक्तवान् एतद् मह्यं न रोचते इति?	kativāraṃ uktavān etad mahyaṃ na rocate iti?	sent.
कतिवारं कथयेयम्?	kativāraṃ kathayeyam?	sent.
कतिवारं वक्तव्यम्?	kativāraṃ vaktavyam?	sent.
कति स्यूताः सन्ति ?	kati syūtāḥ santi ?	sent.
कथञ्चित् तस्य पत्नि एतत् विषयं ज्ञास्यति इति तस्य चिन्ता	kathañcit tasya patni etat viṣayaṃ jñāsyati iti tasya cintā	sent.
कथमपि मया विजयः प्राप्तव्यम्	kathamapi mayā vijayaḥ prāptavyam	sent.
कथमस्ति भवन्?	kathamasti bhavan?	sent.
कथमस्ति भवान्?	kathamasti bhavān?	sent.
कथम् अस्ति भवान् / भवती ?	katham asti bhavān / bhavatī ?	sent.
कथम् उपरि गच्छामि	katham upari gacchāmi	sent.
कथम् एतत् ?	katham etat ?	sent.
कथम् फलानि प्राप्नोमि	katham phalāni prāpnomi	sent.
कथयतु	kathayatu	sent.
कथयतु	kathayatu	imperative
कथं आसीत्?	kathaṃ āsīt?	sent.
कथं आसीत् प्रवासः?	kathaṃ āsīt pravāsaḥ?	sent.
कथं जीवितं धारयिष्यामि	kathaṃ jīvitaṃ dhārayiṣyāmi	sent.
कथं तत् बृहत् आम्रम् ?	kathaṃ tat bṛhat āmram ?	sent.
कथं विस्मरणं भवति भोः?	kathaṃ vismaraṇaṃ bhavati bhoḥ?	sent.
कदा आगतवती ?	kadā āgatavatī ?	sent.
कदा आगतवान्?	kadā āgatavān?	sent.
कदा आगमिष्यति ?	kadā āgamiṣyati ?	sent.
कदा आरभ्य अन्वयः?	kadā ārabhya anvayaḥ?	sent.
कदा उक्तवान् भोः?	kadā uktavān bhoḥ?	sent.
कदाचित् एवमपि स्यात्	kadācit evamapi syāt	sent.
कदा त्वं प्रत्यागच्छसि ?	kadā tvaṃ pratyāgacchasi ?	sent.
कदा ददाति?	kadā dadāti?	sent.
कदा प्रत्यागमिष्यति ?	kadā pratyāgamiṣyati ?	sent.
कदा प्रस्थितवान् ?	kadā prasthitavān ?	sent.
कदा प्रस्थितः?	kadā prasthitaḥ?	sent.
कदा यूयम् प्रस्थितः ?	kadā yūyam prasthitaḥ ?	sent.
कदा वा निर्गच्छति?	kadā vā nirgacchati?	sent.
कन्दुकं क्षिप	kandukaṃ kṣipa	phrase
कन्दुकं धर	kandukaṃ dhara	phrase
कन्यायाः कृते किं किं आभरणं दास्यन्ति?	kanyāyāḥ kṛte kiṃ kiṃ ābharaṇaṃ dāsyanti?	sent.
कपयः तरून् आरोहन्ति	kapayaḥ tarūn ārohanti	sent.
क भाजित ख	ka bhājita kha	phrase
कम्पताम्	kampatām	imperative
क युत ख	ka yuta kha	phrase
करमुक्तं इति दृष्टवान्	karamuktaṃ iti dṛṣṭavān	sent.
करोतु	karotu	sent.
कर्तयतु	kartayatu	imperative
कर्तुं शक्यं, किञ्चित् समयः अपेक्षते	kartuṃ śakyaṃ, kiñcit samayaḥ apekṣate	sent.
कर्मकराः एव दुर्लभाः	karmakarāḥ eva durlabhāḥ	sent.
क वियुत ख	ka viyuta kha	phrase
कस्मिन् महाविद्यालये	kasmin mahāvidyālaye	phrase
कस्मिन् समये?	kasmin samaye?	expr.
कस्मिन् समये आगच्छन्ति अद्य?	kasmin samaye āgacchanti adya?	sent.
कस्मिन् समये प्रतीक्षणीयम्?	kasmin samaye pratīkṣaṇīyam?	sent.
कस्य अयम् प्रकोष्ठः?	kasya ayam prakoṣṭhaḥ?	sentence
कस्य इदम्?	kasya idam?	sent.
कस्य वस्त्रम् इदम्?	kasya vastram idam?	sent.
कस्यां कक्ष्यायाम्	kasyāṃ kakṣyāyām	sent.
का इयं बाला ?	kā iyaṃ bālā ?	sent.
काकः	kākaḥ	fig.
कानि दौर्बल्यानि भवतः ?	kāni daurbalyāni bhavataḥ ?	sent.
काफीचूर्णम्	kāphīcūrṇam	sent.
काफीं भवान् एव रसितवान् , अतः भवता एव वक्तव्यम्	kāphīṃ bhavān eva rasitavān , ataḥ bhavatā eva vaktavyam	sent.
कार्यालयतः तस्य आगमन समयः एषः	kāryālayataḥ tasya āgamana samayaḥ eṣaḥ	sent.
कार्यालयस्य पश्चात्	kāryālayasya paścāt	phrase
कार्यालयस्य समाप्तिः कदा?	kāryālayasya samāptiḥ kadā?	sent.
काले	kāle	loc.
काले काले	kāle kāle	phrase
कालेन कालम्	kālena kālam	phrase
का वार्त्ता ?	kā vārttā ?	sent.
का वेला ?	kā velā ?	sent.
का वेला अधुना वर्नते ?	kā velā adhunā varnate ?	sent.
काशताम्	kāśatām	imperative
काशीं रामेश्वरं सर्वं दृष्टवान् वा?	kāśīṃ rāmeśvaraṃ sarvaṃ dṛṣṭavān vā?	sent.
किञ्चित्	kiñcit	sent.
किञ्चित् उच्चैः वदतु	kiñcit uccaiḥ vadatu	sent.
किञ्चित् एव	kiñcit eva	expr.
किञ्चित्कालम् तिष्ठतु	kiñcitkālam tiṣṭhatu	sent.
किञ्चित् कालं तिष्ठतु	kiñcit kālaṃ tiṣṭhatu	sent.
किञ्चित् कालं द्विचक्रिकां ददाति वा?	kiñcit kālaṃ dvicakrikāṃ dadāti vā?	sent.
किञ्चित् क्षीरं मया पातितम् । इदानीं मार्जयिष्यामि	kiñcit kṣīraṃ mayā pātitam | idānīṃ mārjayiṣyāmi	sent.
किञ्चित् ज्वरः इव	kiñcit jvaraḥ iva	sent.
किञ्चित् वा दध्यन्नस्य भोजनं करोतु	kiñcit vā dadhyannasya bhojanaṃ karotu	sent.
किञ्चित् विश्रान्तिं अनुभवतु	kiñcit viśrāntiṃ anubhavatu	sent.
किञ्चित् व्यञ्जनं परिवेषयतु	kiñcit vyañjanaṃ pariveṣayatu	sent.
किञ्चित् शर्करां ददाति वा?	kiñcit śarkarāṃ dadāti vā?	sent.
किञ्चित् शर्करां योजयतु । ततः भवान् खादितुं शक्यति	kiñcit śarkarāṃ yojayatu | tataḥ bhavān khādituṃ śakyati	sent.
किञ्चित् समञ्जनं कुर्मः	kiñcit samañjanaṃ kurmaḥ	sent.
किञ्चित् साहाय्यं करोति वा?	kiñcit sāhāyyaṃ karoti vā?	sent.
किञ्चित् स्वीकरोति व ?	kiñcit svīkaroti va ?	sent.
किञ्चित् स्वीकरोतु	kiñcit svīkarotu	sent.
किञ्चिदनन्तरं आगच्छेत्	kiñcidanantaraṃ āgacchet	sent.
किञ्चिद्दूरं अहमपि आगच्छामि	kiñciddūraṃ ahamapi āgacchāmi	sent.
किन्तु अस्याः भयम् अस्ति	kintu asyāḥ bhayam asti	phrase
किमपि उक्तवान् वा?	kimapi uktavān vā?	sent.
किमपि चित्रम् ?	kimapi citram ?	sent.
किमपि न भवति	kimapi na bhavati	sent.
किमर्थम् एतावान् विलम्बः ?	kimartham etāvān vilambaḥ ?	sent.
किमर्थम् एवं त्वरा ?	kimartham evaṃ tvarā ?	sent.
किमर्थं अद्य रुचिरेव नास्ति	kimarthaṃ adya rucireva nāsti	sent.
किमर्थं इदानीं अपि कार्यं न आरब्धम्?	kimarthaṃ idānīṃ api kāryaṃ na ārabdham?	sent.
किमर्थं एतावान् विलम्बः?	kimarthaṃ etāvān vilambaḥ?	sent.
किमर्थं एवं सम्भ्रमः?	kimarthaṃ evaṃ sambhramaḥ?	sent.
किमर्थं कण्ठः अवरुद्धः?	kimarthaṃ kaṇṭhaḥ avaruddhaḥ?	sent.
किमर्थं? कः विशेषः?	kimarthaṃ? kaḥ viśeṣaḥ?	sent.
किमर्थं तत् एवं अभवत्?	kimarthaṃ tat evaṃ abhavat?	sent.
किमर्थं तत् एवं जातम् ?	kimarthaṃ tat evaṃ jātam ?	sent.
किमर्थं तद् न भवति?	kimarthaṃ tad na bhavati?	sent.
किमर्थं तावती चिन्ता?	kimarthaṃ tāvatī cintā?	sent.
किमर्थं पूर्वं न उक्तवान्?	kimarthaṃ pūrvaṃ na uktavān?	sent.
किमर्थं प्रतिदिनं विलम्बेन आगच्छन्ति?	kimarthaṃ pratidinaṃ vilambena āgacchanti?	sent.
किमर्थं भवान् क्षुभ्यति?	kimarthaṃ bhavān kṣubhyati?	sent.
किमर्थं भोः?	kimarthaṃ bhoḥ?	expr.
किमर्थं विलम्बः?	kimarthaṃ vilambaḥ?	sent.
किमर्थं वृथा व्ययः इति?	kimarthaṃ vṛthā vyayaḥ iti?	sent.
किमिति पदे पदे आह्वयन्ति?	kimiti pade pade āhvayanti?	sent.
किमिदं, सर्वत्र अवकरः?	kimidaṃ, sarvatra avakaraḥ?	sent.
किम् अकरोत् ?	kim akarot ?	sent.
किम् अपि वार्ता न.	kim api vārtā na.	sent.
किम् अयम् तव प्रकोष्ठः?	kim ayam tava prakoṣṭhaḥ?	sentence
किम् अवदत् ?	kim avadat ?	sent.
किम् इदं तव नूतनं वाहनम्?	kim idaṃ tava nūtanaṃ vāhanam?	sent.
किम् एतत् स्यात्	kim etat syāt	sent.
किम् किम् अपष्यत् ?	kim kim apaṣyat ?	sent.
किम् कुर्वन् असि ?	kim kurvan asi ?	sent.
किम् कुर्वन् अस्ति सः ?	kim kurvan asti saḥ ?	sent.
किम् कुर्वन् आसीः ?	kim kurvan āsīḥ ?	sent.
किम् चिरेण ?	kim cireṇa ?	expr.
किम् तर्हि ?	kim tarhi ?	sent.
किम् विद्यते ?	kim vidyate ?	sent.
कियत् कालं तिष्ठति?	kiyat kālaṃ tiṣṭhati?	sent.
कियत् पर्यन्तं त्वम् अटसि ?	kiyat paryantaṃ tvam aṭasi ?	sent.
कियत् लज्जास्पदम् !	kiyat lajjāspadam !	sent.
कियत् लज्जास्पदम्	kiyat lajjāspadam	sent.
कियत् सुन्दरं अस्तीति जानाति वा?	kiyat sundaraṃ astīti jānāti vā?	sent.
कियद् अस्ति तत्?	kiyad asti tat?	sent.
कियद् इति दातुं शक्यम्?	kiyad iti dātuṃ śakyam?	sent.
कियद् दत्तवती	kiyad dattavatī	sent.
कियद्दूरे अस्ति?	kiyaddūre asti?	sent.
कियान् विलम्बः भोः, शीघ्रं आगच्छतु	kiyān vilambaḥ bhoḥ, śīghraṃ āgacchatu	sent.
किलो कृते कति?	kilo kṛte kati?	sent.
किलो दालस्य कृते कति रूप्यकाणि?	kilo dālasya kṛte kati rūpyakāṇi?	sent.
किं अत्र आगमनम्?	kiṃ atra āgamanam?	sent.
किं अद्य अहं भोजनं करोमि वा?	kiṃ adya ahaṃ bhojanaṃ karomi vā?	sent.
किं, अद्य दातव्यं वा?	kiṃ, adya dātavyaṃ vā?	sent.
किं अम्ब! कियत् परिवेषितवती?	kiṃ amba! kiyat pariveṣitavatī?	sent.
किं अम्ब, प्रतिदिनं सारः एव?	kiṃ amba, pratidinaṃ sāraḥ eva?	sent.
किं, इदानीमपि न आगतवान् वा?	kiṃ, idānīmapi na āgatavān vā?	sent.
किं, इदानीम् एव निद्रा वा?	kiṃ, idānīm eva nidrā vā?	sent.
किं एषा उष्णता भोः!	kiṃ eṣā uṣṇatā bhoḥ!	sent.
किं चिराद् दर्शनं?	kiṃ cirād darśanaṃ?	sent.
किं जातम् ?	kiṃ jātam ?	sent.
किं दृष्टवान् ?	kiṃ  dṛṣṭavān ?	sent.
किं द्वित्रीणि दिनानि न दृष्टा!	kiṃ dvitrīṇi dināni na dṛṣṭā!	sent.
किं, न रोचते वा?	kiṃ, na rocate vā?	sent.
किं पठसि ?	kiṃ paṭhasi ?	sent.
किं बहुना ?	kiṃ bahunā ?	phrase
किं भोः, एकं पत्रं अपि नास्ति?	kiṃ bhoḥ, ekaṃ patraṃ api nāsti?	sent.
किं भोः, एवं वदसि?	kiṃ bhoḥ, evaṃ vadasi?	sent.
किं भोः कोलाहलः	kiṃ bhoḥ kolāhalaḥ	sent.
किं भोः! क्लिन्नः अस्ति!	kiṃ bhoḥ! klinnaḥ asti!	sent.
किं भोः, दर्शनमेव नास्ति!	kiṃ bhoḥ, darśanameva nāsti!	sent.
किं भोः, बहु कृशः जातः?	kiṃ bhoḥ, bahu kṛśaḥ jātaḥ?	sent.
किं भोः, भोजनमेव न करोति?	kiṃ bhoḥ, bhojanameva na karoti?	sent.
किं भोः, वार्ता एव नास्ति?	kiṃ bhoḥ, vārtā eva nāsti?	sent.
किं भोः सम्यक् पठति किल!	kiṃ bhoḥ samyak paṭhati kila!	sent.
किं मम पठनीयं नास्ति वा?	kiṃ mama paṭhanīyaṃ nāsti vā?	sent.
किं वर्षीणो सि ?	kiṃ varṣīṇo si ?	sent.
किं व्याधा वने अस्मिन् सञ्चरन्ति?	kiṃ vyādhā vane asmin sañcaranti?	sent.
किंसङ्ख्याकं यानं जयनगरं गच्छति?	kiṃsaṅkhyākaṃ yānaṃ jayanagaraṃ gacchati?	sent.
कीताः सस्यम् बाधन्ते	kītāḥ sasyam bādhante	sent.
कीदृक् भयङ्कर-शब्दः !	kīdṛk bhayaṅkara-śabdaḥ !	sent.
कीदृशम् इदं फलम् ?	kīdṛśam idaṃ phalam ?	sent.
कीदृशी इयं बाला ?	kīdṛśī iyaṃ bālā ?	sent.
कीदृशः मार्गः अयम् !	kīdṛśaḥ mārgaḥ ayam !	sent.
कुञ्चिकां पार्श्वगृहे दत्वा गच्छामि	kuñcikāṃ pārśvagṛhe datvā gacchāmi	sent.
कुटुम्बेन सह विवाहं गन्तुं त्रीणि कार्यानानि आवश्यकानि	kuṭumbena saha vivāhaṃ gantuṃ trīṇi kāryānāni āvaśyakāni	sent.
कुड्मान् योजयतु	kuḍmān yojayatu	sent.
कुतः आनीतवान् ?	kutaḥ ānītavān ?	sent.
कुत्र आसीद् भवती ?	kutra āsīd bhavatī ?	sent.
कुत्र आसीद् भवान् ?	kutra āsīd bhavān ?	sent.
कुत्र उद्योगं करोति भवती ?	kutra udyogaṃ karoti bhavatī ?	sent.
कुत्र गतवान्? गृहे नास्ति वा?	kutra gatavān? gṛhe nāsti vā?	sent.
कुत्र भवतः निवासः ?	kutra bhavataḥ nivāsaḥ ?	sent.
कुत्र सः ?	kutra saḥ ?	sent.
कुत्रापि न, अत्रैव आसम्	kutrāpi na, atraiva āsam	sent.
कुत्रापि वृष्टिः नास्ति	kutrāpi vṛṣṭiḥ nāsti	sent.
कुत्रापि स्थापयति, अनन्तरं मां पृच्छति	kutrāpi sthāpayati, anantaraṃ māṃ pṛcchati	sent.
कुल्यायोः मध्ये	kulyāyoḥ madhye	phrase
कुशलम्?	kuśalam?	sent.
कुशलम् अस्मि	kuśalam asmi	sent.
कुशलं किम् ?	kuśalaṃ kim ?	sent.
कुशलं वा?	kuśalaṃ vā?	sent.
कुशलः वा?	kuśalaḥ vā?	sent.
कूपस्य कुल्यायाः च मध्ये	kūpasya kulyāyāḥ ca madhye	phrase
कूपीं सम्यक् पिधानं करोतु । अथवा सुगन्धः बहि गमिष्यति	kūpīṃ samyak pidhānaṃ karotu | athavā sugandhaḥ bahi gamiṣyati	sent.
कूप्याः पिधानी कुत्र स्थापितवान् भवान् ? अत्र कुत्रापि नास्ति	kūpyāḥ pidhānī kutra sthāpitavān bhavān ? atra kutrāpi nāsti	sent.
कृते	kṛte	postp.
कृपया	kṛpayā	expr.
कृपया आसनं गृह्णातु	kṛpayā āsanaṃ gṛhṇātu	sent.
कृपया उपविश	kṛpayā upaviśa	sent.
कृपया उपविशतु	kṛpayā upaviśatu	sent.
कृपया एकचषकं जलं आनयतु	kṛpayā ekacaṣakaṃ jalaṃ ānayatu	sent.
कृपया एतत् कृष्णं सूचयतु	kṛpayā etat kṛṣṇaṃ sūcayatu	sent.
कृपया एतद् बहिः क्षिपतु	kṛpayā etad bahiḥ kṣipatu	sent.
कृपया गङ्गातीरे एकं लघु कुटीरं निर्माय मां ददातु इति साधुः प्रार्थितवान्	kṛpayā gaṅgātīre ekaṃ laghu kuṭīraṃ nirmāya māṃ dadātu iti sādhuḥ prārthitavān	sent.
कृपया तम् आह्वयति वा?	kṛpayā tam āhvayati vā?	sent.
कृपया तान् पङ्क्त्या उपवेशयतु । अध्यापकः इदानीम् आगमिष्यति ।	kṛpayā tān paṅktyā upaveśayatu | adhyāpakaḥ idānīm āgamiṣyati |	sent.
कृपया देयकं / प्राप्तिपत्रं ददातु	kṛpayā deyakaṃ  /  prāptipatraṃ dadātu	sent.
कृपया द्वारं पिधाय निर्गच्छतु	kṛpayā  dvāraṃ pidhāya nirgacchatu	sent.
कृपया नीरवं पठ	kṛpayā nīravaṃ paṭha	sent.
कृपया भवान् मया सह पिबतु .	kṛpayā bhavān mayā saha pibatu .	sent.
कृपया मनसि पठतु	kṛpayā manasi paṭhatu	sent.
कृपया वातायनस्य द्वारस्य उद्घाटनं कृत्वा धूमपानं करोतु	kṛpayā vātāyanasya dvārasya udghāṭanaṃ kṛtvā dhūmapānaṃ karotu	sent.
कृपया श्वः आगच्छतु	kṛpayā śvaḥ āgacchatu	sent.
कृपया सर्वबन्धकं स्वीकरोतु	kṛpayā sarvabandhakaṃ svīkarotu	sent.
कृष्णः गृहे अस्ति वा?	kṛṣṇaḥ gṛhe asti vā?	sent.
के इमे पुरुषाः ?	ke ime puruṣāḥ ?	sent.
के इमे बालकाः?	ke ime bālakāḥ?	sent.
केचन जनाः स्वार्थिनः	kecana janāḥ svārthinaḥ	sent.
केन प्रकारेण	kena prakāreṇa	phrase
केन यानेन आगतवती ?	kena yānena āgatavatī ?	sent.
केनापि कारणेन	kenāpi kāraṇena	phrase
केन्द्रे	kendre	loc.
केवलं धनं व्यर्थम्	kevalaṃ dhanaṃ vyartham	sent.
केवलं निःसारं, जामिता भवति	kevalaṃ niḥsāraṃ, jāmitā bhavati	sent.
केशान् कर्तय	keśān kartaya	sent.
केशान् सम्यक् प्रसाधय	keśān samyak prasādhaya	sent.
कोपि विशेषः?	kopi viśeṣaḥ?	expr.
कोलाहलं मा करोतु	kolāhalaṃ mā karotu	sent.
कः अपेक्षितः?	kaḥ apekṣitaḥ?	sent.
कः अयम् महान् सौधः?	kaḥ ayam mahān saudhaḥ?	sent.
कः त्वम् ?	kaḥ tvam ?	sent.
कः दूरवाणीं कृतवान् इति वदामि?	kaḥ dūravāṇīṃ kṛtavān iti vadāmi?	sent.
कः निर्देशकः?	kaḥ nirdeśakaḥ?	sent.
कः प्रतिक्षते भोः?	kaḥ pratikṣate bhoḥ?	sent.
कः लवणं आवश्यकं इति उक्तवान् ?	kaḥ lavaṇaṃ āvaśyakaṃ iti uktavān ?	sent.
कः वदति ?	kaḥ vadati ?	sent.
कः विशेषः ?	kaḥ viśeṣaḥ ?	sent.
कः विशेषः?	kaḥ viśeṣaḥ?	sent.
कः वृत्तान्तः ?	kaḥ vṛttāntaḥ ?	phrase
कः वृत्तान्तः ?	kaḥ vṛttāntaḥ ?	sent.
कः समयः?	kaḥ samayaḥ?	sent.
कः समयः इति जानाति वा?	kaḥ samayaḥ iti jānāti vā?	sent.
क्रुद्धकुक्कुरं मा स्पृश ! तस्य तीव्रैर्दन्तैस्त्वां दशेत् !	kruddhakukkuraṃ mā spṛśa ! tasya tīvrairdantaistvāṃ daśet !	sent.
क्रुद्धः सर्पः फणां प्रसार्य फूत्कृतवान्	kruddhaḥ sarpaḥ phaṇāṃ prasārya phūtkṛtavān	sent.
क्लेशस्यात्मा पदमुपनीतः	kleśasyātmā padamupanītaḥ	sent.
क्व गतः तव मय्यनुरागः?	kva gataḥ tava mayyanurāgaḥ?	sent.
क्वथितापेक्षया सारः एव रुचिकरः	kvathitāpekṣayā sāraḥ eva rucikaraḥ	sent.
क्व सुखम्?	kva sukham?	phrase
क्षणात्	kṣaṇāt	abl.
क्षणं तिष्ठ	kṣaṇaṃ tiṣṭha	sent.
क्षमस्व	kṣamasva	sent.
क्षमस्व, तव गृहम् कुत्र अस्ति?	kṣamasva, tava gṛham kutra asti?	sent.
क्षम्यताम्	kṣamyatām	expr.
क्षम्यताम्, काचित् व्यस्ता आसम् अतः भवता प्रेषितं पत्रं दृष्टुं विलम्बः अभवत् इति इन्दिरा उक्तवती	kṣamyatām, kācit vyastā āsam ataḥ bhavatā preṣitaṃ patraṃ dṛṣṭuṃ vilambaḥ abhavat iti indirā uktavatī	sent.
क्षम्यताम् , न जानामि .	kṣamyatām , na jānāmi .	sent.
क्षम्यताम् , न स्मरामि .	kṣamyatām , na smarāmi .	sent.
क्षम्यताम् , मया विस्मृतम्	kṣamyatām , mayā vismṛtam	sent.
क्षम्यताम् । शयनसमये चायपानीयं न पिबामि	kṣamyatām |  śayanasamaye cāyapānīyaṃ na pibāmi	sent.
क्षम्यताम् , सः गृहे नास्ति	kṣamyatām , saḥ gṛhe nāsti	sent.
क्षीरम्	kṣīram	sent.
क्षीरार्थं अद्य एव दातव्यं अस्ति	kṣīrārthaṃ adya eva dātavyaṃ asti	sent.
क्षीरं ददातु	kṣīraṃ dadātu	sent.
क्षीरं दूषितम्	kṣīraṃ dūṣitam	sent.
खटखटायस्व	khaṭakhaṭāyasva	sent.
खलाः सुराम् अपिबन्	khalāḥ surām apiban	sent.
खलु	khalu	sent.
गच्छता कालेन	gacchatā kālena	phrase
गजस्नानम्	gajasnānam	fig.
गजः कथं मृतः ?	gajaḥ kathaṃ mṛtaḥ ?	sent.
गणितश्रवणमात्रेण मम शिरोवेदना	gaṇitaśravaṇamātreṇa mama śirovedanā	sent.
गणितस्य अध्यापकः अस्ति वा पश्यतु	gaṇitasya adhyāpakaḥ asti vā paśyatu	sent.
गणिते दश अङ्काः एव इति स्मरति वा?	gaṇite daśa aṅkāḥ eva iti smarati vā?	sent.
गणितं पठामि	gaṇitaṃ paṭhāmi	sentence
गतग्रीष्मच्छुट्टौ	gatagrīṣmacchuṭṭau	phrase
गतदुर्गापूजायाम्	gatadurgāpūjāyām	phrase
गतपूर्णिमायाम्	gatapūrṇimāyām	phrase
गतप्रभाते	gataprabhāte	phrase
गतमङ्गलवारे एकवादनात् परम्	gatamaṅgalavāre ekavādanāt param	phrase
गतमङ्गलवारे षड्वादने	gatamaṅgalavāre ṣaḍvādane	phrase
गतरात्रौ	gatarātrau	phrase
गतवर्गे	gatavarge	phrase
गतवर्षे तत्र निर्देशकः आसम्	gatavarṣe tatra nirdeśakaḥ āsam	sent.
गतशताब्द्याम्	gataśatābdyām	phrase
गतशुक्लचतुर्दश्याम्	gataśuklacaturdaśyām	phrase
गतसहस्राब्द्याम्	gatasahasrābdyām	phrase
गतसायम्	gatasāyam	phrase
गतापराह्णे	gatāparāhṇe	phrase
गतैकादश्याम्	gataikādaśyām	phrase
गत्वा शयनं करोतु	gatvā śayanaṃ karotu	sent.
गमनात् अनुक्षणमेव पत्रं लिखतु	gamanāt anukṣaṇameva patraṃ likhatu	sent.
गलीना षड्वादनतः सप्तवादनं पर्यन्तं योगासनम् करोति	galīnā ṣaḍvādanataḥ saptavādanaṃ paryantaṃ yogāsanam karoti	sent.
गलीना स्वस्य शुनकेन सार्धं उद्यानं गतवती	galīnā svasya śunakena sārdhaṃ udyānaṃ gatavatī	sent.
गाढं अभ्यासः वा?	gāḍhaṃ abhyāsaḥ vā?	sent.
गिरिनगरार्थं यात्रापत्रद्वयं ददातु	girinagarārthaṃ yātrāpatradvayaṃ dadātu	sent.
गीतं शृणवाम	gītaṃ śṛṇavāma	sent.
गृहकार्यां करोमि .	gṛhakāryāṃ karomi .	sent.
गृहकार्यं सर्वं समाप्तं वा?	gṛhakāryaṃ sarvaṃ samāptaṃ vā?	sent.
गृहपाठः समाप्तः वा?	gṛhapāṭhaḥ samāptaḥ vā?	sent.
गृहस्य वामतः एव सर्वाणि पुष्पसस्यानि आरोपयाम । तदेव सुन्दरं भविष्यति	gṛhasya vāmataḥ eva sarvāṇi puṣpasasyāni āropayāma | tadeva sundaraṃ bhaviṣyati	sent.
गृहे	gṛhe	loc.
गृहे उपविश्य किं करोति?	gṛhe upaviśya kiṃ karoti?	sent.
गृहे किमपि पठन्ति वा?	gṛhe kimapi paṭhanti vā?	sent.
गृहे मम करौ मुखं च क्षालयामि.	gṛhe mama karau mukhaṃ ca kṣālayāmi.	sent.
गृहे मिलेत् वा?	gṛhe milet vā?	sent.
गृहे सर्वे कुशलम् इति विश्वसिमि अहम् ।	gṛhe sarve kuśalam iti viśvasimi aham |	sent.
गृहे सर्वे कुशलिनः किम् ?	gṛhe sarve kuśalinaḥ kim ?	sent.
गृहे सर्वे कुशलिनः वा?	gṛhe sarve kuśalinaḥ vā?	sent.
गोपलात् बलवत्तर	gopalāt balavattara	phrase
गोविन्द, आपणं गत्वा आगच्छति वा?	govinda, āpaṇaṃ gatvā āgacchati vā?	sent.
ग्रामे अध्यापकः अस्मि	grāme adhyāpakaḥ asmi	sent.
घण्टा नादिता वा?	ghaṇṭā nāditā vā?	sent.
घर्मो घर्मः	gharmo gharmaḥ	sent.
घा उन्नीत य	ghā unnīta ya	phrase
घा घात य	ghā ghāta ya	phrase
चक्रमिव जीवने परिवर्तन्ते सुखानि च दुःखानि च.	cakramiva jīvane parivartante sukhāni ca duḥkhāni ca.	sent.
चतुरः पाठम् अपठत्	caturaḥ pāṭham apaṭhat	sent.
चतुर्थी विभक्ति	caturthī vibhakti	phrase
चतुर्भ्यः दिनेभ्यः परम्	caturbhyaḥ dinebhyaḥ param	phrase
चतुर्भ्यः दिनेभ्यः पूर्वम्	caturbhyaḥ dinebhyaḥ pūrvam	phrase
चत्वारि रूप्यकाणि	catvāri rūpyakāṇi	phrase
चलच्चित्रम् ईक्षितुम्	calaccitram īkṣitum	phrase
चलच्चित्रं दृष्टुं गच्छाम	calaccitraṃ dṛṣṭuṃ gacchāma	sent.
चलितुम् अशक्तौ सन्तौ	calitum aśaktau santau	sent.
चायपानं कुरु	cāyapānaṃ kuru	sent.
चिकित्सकेन प्रयोजनम् अस्ति	cikitsakena prayojanam asti	sent.
चित्रमन्दिरं पूर्णं आसीत्	citramandiraṃ pūrṇaṃ āsīt	sent.
चित्रं कथं आसीत्?	citraṃ kathaṃ āsīt?	sent.
चिन्ता मास्तु	cintā māstu	sent.
चिन्ता मास्तु, श्वः ददातु	cintā māstu, śvaḥ dadātu	sent.
चिरं जीव भव	ciraṃ jīva bhava	sent.
चीटिका न लब्धा वा?	cīṭikā na labdhā vā?	sent.
चीटिकां कुत्र क्रीणामि?	cīṭikāṃ kutra krīṇāmi?	sent.
चौरे सावधानम्	caure sāvadhānam	phrase
छात्राः प्रश्नम् अपृच्छन्	chātrāḥ praśnam apṛcchan	sent.
छात्राः सङ्गीतं शृण्वन्ति	chātrāḥ saṅgītaṃ śṛṇvanti	sent.
छे, एवं न भवितव्यं आसीत्	che, evaṃ na bhavitavyaṃ āsīt	sent.
जनाः आलोकन्ते	janāḥ ālokante	sent.
जयन्त	jayanta	a
जलम् वहति	jalam vahati	sent.
जलेन	jalena	instr.
जलं पूरयतु	jalaṃ pūrayatu	sent.
जलं यदा क्वथति तदा चमसमितं चायचूर्णं जले योजयतु	jalaṃ yadā kvathati tadā camasamitaṃ cāyacūrṇaṃ jale yojayatu	sent.
जाग्रत् सुषुप्ति	jāgrat suṣupti	phrase
जाते	jāte	loc.
जातेन खलु मर्तव्यम्	jātena khalu martavyam	sent.
जानामि भोः	jānāmi bhoḥ	expr.
जीवने कर्तार एव सुखम् अधिगच्छन्ति.	jīvane kartāra eva sukham adhigacchanti.	sent.
जीवन् व्रजति	jīvan vrajati	sent.
जून प्रथम दिनाङ्के	jūna prathama dināṅke	sent.
ज्ञातं वा?	jñātaṃ vā?	expr.
ज्ञात्र	jñātra	v.
ज्वरपीडितः वा? कदा आरभ्य?	jvarapīḍitaḥ vā? kadā ārabhya?	sent.
झटिति आगच्छ	jhaṭiti āgaccha	sent.
टिप्पणीं किञ्चित् ददाति वा?	ṭippaṇīṃ kiñcit dadāti vā?	sent.
टिप्पणीं लिखन्तु	ṭippaṇīṃ likhantu	sent.
तक्रं न इच्छति वा?	takraṃ na icchati vā?	sent.
तटे सर्वदा पादरक्षः उपयोक्तव्यः किल ?	taṭe sarvadā pādarakṣaḥ upayoktavyaḥ kila ?	sent.
तण्डुलः धान्यतः आगच्छति	taṇḍulaḥ dhānyataḥ āgacchati	sent.
तण्डुलः सम्यक् नास्ति	taṇḍulaḥ samyak nāsti	sent.
ततस् ततः	tatas tataḥ	phrase
ततो ऽपरम्	tato  param	phrase
ततः आगन्तुं एतावान् विलम्बः वा?	tataḥ āgantuṃ etāvān vilambaḥ vā?	sent.
ततः कथम्	tataḥ katham	phrase
ततः क्षणम्	tataḥ kṣaṇam	phrase
ततः क्षणात्	tataḥ kṣaṇāt	phrase
ततः परम्	tataḥ param	phrase
तत् अतीव अल्पमूल्यम्	tat atīva alpamūlyam	sent.
तत् अहमपि जानामि	tat ahamapi jānāmi	sent.
तत् कस्य वाहनम्?	tat kasya vāhanam?	sent.
तत्कारणतः इदानीं अनुभवतु	tatkāraṇataḥ idānīṃ anubhavatu	sent.
तत् किमपि मास्तु	tat kimapi māstu	expr.
तत् किम् ?	tat kim ?	sent.
तत्क्षणम्	tatkṣaṇam	acc.
तत् गृहम् कस्य?	tat gṛham kasya?	sentence
तत् गृहम् बहु विशालम्	tat gṛham bahu viśālam	sent.
तत् तथा न?	tat tathā na?	expr.
तत् तुभ्यम् रोचते ?	tat tubhyam rocate ?	sent.
तत् न रोचते?	tat na rocate?	sent.
तत् पश्चात्	tat paścāt	phrase
तत्पूर्वं कृपया पातुं किञ्चित् जलं ददातु	tatpūrvaṃ kṛpayā pātuṃ kiñcit jalaṃ dadātu	sent.
तत् मम कर्तव्यम्	tat mama kartavyam	sent.
तत् मम नगरम्	tat mama nagaram	sent.
तत्र अन्तर	tatra antara	phrase
तत्र अस्ति वा नास्ति वा इति प्रथमं एव द्रष्टव्यम्	tatra asti vā nāsti vā iti prathamaṃ eva draṣṭavyam	sent.
तत्र अहं किमपि न वदामि	tatra ahaṃ  kimapi na vadāmi	sent.
तत्र आसीत् किम् ?	tatra āsīt kim ?	sent.
तत्र आसीत् वा?	tatra āsīt vā?	sent.
तत्र कोपि सन्देहः नास्ति	tatra kopi sandehaḥ nāsti	sent.
तत्र गत्वा किं करोति?	tatra gatvā kiṃ karoti?	sent.
तत्र गमनं मास्तु भोः, सः बहुमूल्यं वदति ।	tatra gamanaṃ māstu bhoḥ, saḥ bahumūlyaṃ vadati |	sent.
तत्र नासीत्	tatra nāsīt	sent.
तत्र महान् सम्मर्दः अस्ति	tatra mahān sammardaḥ asti	sent.
तत्रैव अस्ति	tatraiva asti	sent.
तत्रैव कुत्रापि स्यात्	tatraiva kutrāpi syāt	sent.
तत् वाहनं कस्य ?	tat vāhanaṃ kasya ?	sent.
तत् वाहनं न मदीयम्	tat vāhanaṃ na madīyam	sent.
तत् शोभनम्	tat śobhanam	sent.
तत् सभागृहम्	tat sabhāgṛham	sent.
तथा किमपि नास्ति	tathā kimapi nāsti	expr.
तथा किमर्थं वदति?	tathā kimarthaṃ vadati?	sent.
तथा कः उक्तवान् इति वयं जानीमः	tathā kaḥ uktavān iti vayaṃ jānīmaḥ	sent.
तथा चेत् श्वः भवान् एव पाकं करोतु	tathā cet śvaḥ bhavān eva pākaṃ karotu	sent.
तथापि	tathāpi	expr.
तथापि नूतनं इव प्रतिभाति	tathāpi nūtanaṃ iva pratibhāti	sent.
तथा भवति वा?	tathā bhavati vā?	sent.
तथा मा वद	tathā mā vada	sent.
तथास्तु	tathāstu	imp.
तथा हि	tathā hi	phrase
तथैव अस्तु	tathaiva astu	expr.
तथैव इति न नियमः	tathaiva iti na niyamaḥ	sent.
तदनन्तरम्	tadanantaram	expr.
तदर्थं वा?	tadarthaṃ vā?	expr.
तदहं बहु इच्छामि	tadahaṃ bahu icchāmi	sent.
तदा तदा उदरवेदना पीडयति किल?	tadā tadā udaravedanā pīḍayati kila?	sent.
तदा तद् न स्फुरितम्	tadā tad na sphuritam	sent.
तदानीमेव उक्तवान् किल?	tadānīmeva uktavān  kila?	sent.
तदेव अहम् अकथयम्	tadeva aham akathayam	sent.
तद् अहं अपि जानामि	tad ahaṃ api jānāmi	sent.
तद् अहं न ज्ञातवान्	tad ahaṃ na jñātavān	sent.
तद् अहं बहु इच्छामि !	tad ahaṃ bahu icchāmi !	sent.
तद् किञ्चित् परिवेषयतु	tad kiñcit pariveṣayatu	sent.
तद्दिने किमर्थं भवान् न आगतवान्?	taddine kimarthaṃ bhavān na āgatavān?	sent.
तद्धनं मदीयमिति स भाषते	taddhanaṃ madīyamiti sa bhāṣate	sent.
तद्विषये चिन्ता मास्तु	tadviṣaye cintā māstu	sent.
तद् व्यवस्थां अहं करोमि	tad vyavasthāṃ ahaṃ karomi	sent.
तयोः कतमस्मै ?	tayoḥ katamasmai ?	expr.
तयोः पुत्रः कः ?	tayoḥ putraḥ kaḥ ?	sent.
तर न	tara na	phrase
तर्हि किमर्थं द्रष्टव्यम्?	tarhi kimarthaṃ draṣṭavyam?	sent.
तर्हि कुत्र दृष्टवान्?	tarhi kutra dṛṣṭavān?	sent.
तर्हि तत्रैव दृष्टवान्	tarhi tatraiva dṛṣṭavān	sent.
तर्हि पानकं आनयामि	tarhi pānakaṃ ānayāmi	sent.
तर्हि समीचीनम्	tarhi samīcīnam	expr.
तर्हि समीचीनं एव स्यात्	tarhi samīcīnaṃ eva syāt	sent.
तर्हि सर्वं दायित्वं भवतः एव	tarhi sarvaṃ dāyitvaṃ bhavataḥ eva	sent.
तव गुरवः के?	tava guravaḥ ke?	sent.
तव देशः कतमः?	tava deśaḥ katamaḥ?	sent.
तव देशः कः ?	tava deśaḥ kaḥ ?	sent.
तव नाम किम्?	tava nāma kim?	sent.
तव निवासः कुत्र ?	tava nivāsaḥ kutra ?	sent.
तव नूतनं वाहनम्	tava nūtanaṃ vāhanam	sent.
तव भ्राता कथमस्ति?	tava bhrātā kathamasti?	sent.
तव मार्गः कुत्र अस्ति ?	tava mārgaḥ kutra asti ?	sent.
तव मित्रम्	tava mitram	phrase
तव वाहनेन सदृशम्	tava vāhanena sadṛśam	phrase
तव वैद्यः कः ?	tava vaidyaḥ kaḥ ?	sent.
तव हृदयम् अनुगच्छ	tava hṛdayam anugaccha	sent.
तस्मात् कारणात् एव अहम् वदामि तया सह मा गच्छतु इति	tasmāt kāraṇāt eva aham vadāmi tayā saha mā gacchatu iti	sent.
तस्मिन् अन्तर	tasmin antara	phrase
तस्मै कार्यक्रमाय सः नूयार्क्-नगरतः आगतवान् वा ? सः परोपकारी एव	tasmai kāryakramāya saḥ nūyārk-nagarataḥ āgatavān vā ? saḥ paropakārī eva	sent.
तस्य आरोग्यं कथम् अस्ति?	tasya ārogyaṃ katham asti?	sent.
तस्य एकः पुत्रः आसीत्	tasya ekaḥ putraḥ āsīt	sent.
तस्य औदार्यम् विख्यातम्	tasya audāryam vikhyātam	sent.
तस्य कति अपत्यानि ?	tasya kati apatyāni ?	sent.
तस्य कथां विस्तरेण श्रावयामि	tasya kathāṃ vistareṇa śrāvayāmi	sent.
तस्य कृते किमर्थं दत्तवान्?	tasya kṛte kimarthaṃ dattavān?	sent.
तस्य कृते चत्वारि दत्तवती, मम कृते तु त्रीणि एव!	tasya kṛte catvāri dattavatī, mama kṛte tu trīṇi eva!	sent.
तस्य कृते रमः अत्यन्तं प्रीतिपात्रम्	tasya kṛte ramaḥ atyantaṃ prītipātram	sent.
तस्य कृते विषयः निवेदितः वा?	tasya kṛte viṣayaḥ niveditaḥ vā?	sent.
तस्य कौशलं प्रसिद्धम्	tasya kauśalaṃ prasiddham	sent.
तस्य कः अर्थः?	tasya kaḥ arthaḥ?	expr.
तस्य चत्वारि अपत्यानि	tasya catvāri apatyāni	sent.
तस्य दूरवाणी सङ्ख्या का?	tasya dūravāṇī saṅkhyā kā?	sent.
तस्य परिहासं शृणु	tasya parihāsaṃ śṛṇu	sent.
तस्य पुत्री बहु दयावती	tasya putrī bahu dayāvatī	sent.
तस्य पुत्र्यः दनिकानेव इष्टवत्यः	tasya putryaḥ danikāneva iṣṭavatyaḥ	sent.
तस्य माता स्वस्य हस्ताभ्याम् तस्य युतकम् स्यूतवती	tasya mātā svasya hastābhyām tasya yutakam syūtavatī	sent.
तस्य मूल्यम्	tasya mūlyam	phrase
तस्यानेन वस्त्रेन प्रयोजनम्	tasyānena vastrena prayojanam	sent.
तस्यां द्रोण्यां जलम् नास्ति ।	tasyāṃ droṇyāṃ jalam nāsti |	sent.
तस्याः आह्वानं मया न श्रुतम्	tasyāḥ āhvānaṃ mayā na śrutam	sent.
तस्याः पुत्रः निश्चयेन प्रत्यागमिष्यति इति चिन्तयती अञ्जनी, प्रतिदिनं तस्य आगमनं प्रतीक्षां कृतवती	tasyāḥ putraḥ niścayena pratyāgamiṣyati iti cintayatī añjanī, pratidinaṃ tasya āgamanaṃ pratīkṣāṃ kṛtavatī	sent.
तस्याः वेला न आसीत्	tasyāḥ velā na āsīt	sent.
ताज्महल् कुत्र अस्ति ?	tājmahal kutra asti ?	sent.
तानि कदलीफलानि.	tāni kadalīphalāni.	sent.
तान् एव	tān eva	phrase
तावत्	tāvat	phrase
तावदेव किल?	tāvadeva kila?	expr.
तावद् आवश्यकं न	tāvad āvaśyakaṃ na	sent.
तासु द्रोणीषु किम् अस्ति ?	tāsu droṇīṣu kim asti ?	sent.
ताः महिलाः सौन्दर्यभरिताः आसन्	tāḥ mahilāḥ saundaryabharitāḥ āsan	sent.
तिष्ठतु, अहं स्मरामि तत्	tiṣṭhatu, ahaṃ smarāmi tat	sent.
तिष्ठतु, ददामि	tiṣṭhatu, dadāmi	sent.
तिष्ठतु भोः	tiṣṭhatu bhoḥ	expr.
तिष्ठतु भोः, एकम् काफीं पिबामः	tiṣṭhatu bhoḥ, ekam kāphīṃ pibāmaḥ	sent.
तिष्ठतु, युतकं परिवर्त्य आगच्छामि	tiṣṭhatu, yutakaṃ parivartya āgacchāmi	sent.
तिष्ठतु सखि !	tiṣṭhatu sakhi !	sent.
तिस्रः युवतयः नद्यां तरणं कुर्वन्ति	tisraḥ yuvatayaḥ nadyāṃ taraṇaṃ kurvanti	sent.
तीव्रं मा परिगणयतु	tīvraṃ mā parigaṇayatu	sent.
तूष्णीम् !	tūṣṇīm !	phrase
तूष्णीं तिष्ठ !	tūṣṇīṃ tiṣṭha !	sentence
तूष्णीं भोजनं करोतु वा?	tūṣṇīṃ bhojanaṃ karotu vā?	sent.
तृतीया विभक्ति	tṛtīyā vibhakti	phrase
ते अद्य वाराणस्याम् सन्ति.	te adya vārāṇasyām santi.	sent.
ते अहसन्	te ahasan	sent.
ते तु बालाः किल!	te tu bālāḥ kila!	sent.
तेन किमपि न सिध्यति	tena kimapi  na sidhyati	sent.
तेन किम् ?	tena kim ?	phrase
तेन सह	tena saha	phrase
तेन सह न गच्छतु इति दशवारं उक्तवती	tena saha na gacchatu iti daśavāraṃ uktavatī	sent.
तेमनं न परिवेषितवती एव	temanaṃ na pariveṣitavatī eva	sent.
ते रमन्ते	te ramante	sent.
ते विद्यालये पठन्ति	te vidyālaye paṭhanti	sent.
तेषां कृते मम शुभाशयान् निवेदयतु	teṣāṃ kṛte mama śubhāśayān nivedayatu	sent.
तेषां गृहे किं खादितवान्?	teṣāṃ gṛhe kiṃ khāditavān?	sent.
तेषां पुत्र्याः विवाहः निश्चितः इति श्रुतवान्	teṣāṃ putryāḥ vivāhaḥ niścitaḥ iti śrutavān	sent.
तेषु प्रदेशेषु हिमपातः अधिकम्	teṣu pradeśeṣu himapātaḥ adhikam	sent.
ते सर्वदा कलहं कुर्वन्ति	te sarvadā kalahaṃ kurvanti	sent.
ते सर्वे	te sarve	phrase
ते सर्वे गुणिनः.	te sarve guṇinaḥ.	sent.
ते सर्वे सुखिनः	te sarve sukhinaḥ	sent.
ते सर्वे स्वकुटुम्बैः सह सन्ति.	te sarve svakuṭumbaiḥ saha santi.	sent.
तौ उभौ	tau ubhau	phrase
तं अत्र आगन्तुं सूचयतु	taṃ atra āgantuṃ sūcayatu	sent.
तं अहं सम्यक् जानामि	taṃ ahaṃ samyak jānāmi	sent.
तं दूरभाषेण वद	taṃ dūrabhāṣeṇa vada	sent.
तं मार्गं दर्शय	taṃ mārgaṃ darśaya	sent.
तं यानं आरोप्य आगच्छतु	taṃ yānaṃ āropya āgacchatu	sent.
त्रयः बालकाः पादकन्दुकं क्रीडन्ति	trayaḥ bālakāḥ pādakandukaṃ krīḍanti	sent.
त्रिचक्रिका किमर्थम्?	tricakrikā kimartham?	sent.
त्रिचक्रिकायाम्	tricakrikāyām	phrase
त्रिचक्रिकायां एव गच्छामः	tricakrikāyāṃ eva gacchāmaḥ	sent.
त्रिभ्यः वर्षेभ्यः पूर्वम्	tribhyaḥ varṣebhyaḥ pūrvam	phrase
त्रिवादने एकं यानं अस्ति	trivādane ekaṃ yānaṃ asti	sent.
त्रिवादने किम् ?	trivādane kim ?	sent.
त्वम् अवदः	tvam avadaḥ	sent.
त्वम् उत्तिष्ठ	tvam uttiṣṭha	sent.
त्वम् कलाकारः ?	tvam kalākāraḥ ?	sent.
त्वम् क्षीरं पिब	tvam kṣīraṃ piba	sent.
त्वम् बुद्धिमान्	tvam buddhimān	sent.
त्वम् मम मित्रम्	tvam mama mitram	sent.
त्वम् यतसे	tvam yatase	sent.
त्वम् वर्तसे	tvam vartase	sent.
त्वम् शोबसे	tvam śobase	sent.
त्वम् सत्यम् कलाकारः ?	tvam satyam kalākāraḥ ?	sent.
त्वम् संस्कृतं वदसि ?	tvam saṃskṛtaṃ vadasi ?	sent.
त्वरितं कार्यम् आसीत् अतः आगतवान्	tvaritaṃ kāryam āsīt ataḥ āgatavān	sent.
त्वां कामयामि	tvāṃ kāmayāmi	sent.
त्वां धन्यं वदामि	tvāṃ dhanyaṃ vadāmi	sent.
त्वं कुत्र असि ?	tvaṃ kutra asi ?	sent.
त्वं गच्छ	tvaṃ gaccha	sent.
त्वं प्रयतिष्यसे चेत् वर्धिष्यसे	tvaṃ prayatiṣyase cet vardhiṣyase	sent.
त्वं प्रातः किं खादसि?	tvaṃ prātaḥ kiṃ khādasi?	sent.
त्वं फलानि अपि खादसि?	tvaṃ phalāni api khādasi?	sent.
त्वं मे प्रियतमा	tvaṃ me priyatamā	sent.
दक्षिणतो गच्छ	dakṣiṇato gaccha	phrase
दक्षिणे भागे	dakṣiṇe bhāge	phrase
ददातु	dadātu	sent.
दध्यन्नं परिवेषयामि वा?	dadhyannaṃ pariveṣayāmi vā?	sent.
दन्तधावनं कृतं वा?	dantadhāvanaṃ kṛtaṃ vā?	sent.
दन्तफेनः अस्ति वा?	dantaphenaḥ asti vā?	sent.
दन्तमार्जनं करोमि	dantamārjanaṃ karomi	sentence
दशपैसाः न्यूनाः सन्ति	daśapaisāḥ nyūnāḥ santi	sent.
दशवारं पठितवान्, तथापि न स्मरामि	daśavāraṃ paṭhitavān, tathāpi na smarāmi	sent.
दिनत्रयात् परम्	dinatrayāt param	phrase
दिनत्रयात् पूर्वम्	dinatrayāt pūrvam	phrase
दिनत्रयं तत्र स्थितवान्	dinatrayaṃ tatra sthitavān	sent.
दिनद्वयात् परम्	dinadvayāt param	phrase
दिनद्वयात् पूर्वम्	dinadvayāt pūrvam	phrase
दिनद्वयं तिष्ठतु भोः	dinadvayaṃ tiṣṭhatu bhoḥ	sent.
दिने दिने शीतं अधिकं भवति	dine dine śītaṃ adhikaṃ bhavati	sent.
दीपान् ज्वालयतु	dīpān jvālayatu	sent.
दीपान् निर्वापयतु	dīpān nirvāpayatu	sent.
दीपावली शुभाशयाः	dīpāvalī śubhāśayāḥ	sent.
दुर्जनः परिहर्तव्यः	durjanaḥ parihartavyaḥ	sent.
दूषितः कालः	dūṣitaḥ kālaḥ	sent.
दृढ्ग्रहण	dṛḍhgrahaṇa	v.
दृष्टुं एव न शक्यते	dṛṣṭuṃ eva na śakyate	sent.
देश -	deśa -	suffix
देश-काल-विधानेन	deśa-kāla-vidhānena	phrase
दैवेच्छा तदा आसीत्, किं कुर्मः?	daivecchā tadā āsīt, kiṃ kurmaḥ?	sent.
द्राविडप्राणायामेन न वदतु, साक्षात् वदतु	drāviḍaprāṇāyāmena na vadatu, sākṣāt vadatu	sent.
द्वयोः एकः आगच्छतु	dvayoḥ ekaḥ āgacchatu	sent.
द्वारपिधानं करोतु	dvārapidhānaṃ karotu	sent.
द्वारम् उद्घाटय	dvāram udghāṭaya	sent.
द्वारे शब्दापय	dvāre śabdāpaya	sent.
द्वारं पिदधातु	dvāraṃ pidadhātu	sent.
द्वारं सम्यक् ताडयतु , अन्यथा सः न श्रोष्यति	dvāraṃ samyak tāḍayatu , anyathā saḥ na śroṣyati	sent.
द्वितीया विभक्ति	dvitīyā vibhakti	phrase
द्विवादने अवश्यं गन्तव्यं अस्ति	dvivādane avaśyaṃ gantavyaṃ asti	sent.
द्विवारं त्रिवारं वा?	dvivāraṃ trivāraṃ vā?	sent.
द्वे शते सार्धे	dve śate sārdhe	phrase
द्वौ नञौ प्रकृतार्थं गमयतः	dvau nañau prakṛtārthaṃ gamayataḥ	phrase
धनविषये जागरूको भवतु	dhanaviṣaye jāgarūko bhavatu	sent.
धनं ददातु	dhanaṃ dadātu	sent.
धन्यवादः	dhanyavādaḥ	sent.
धर	dhara	suffix
धान्यानि सस्येभ्यः आगच्छन्ति	dhānyāni sasyebhyaḥ āgacchanti	sent.
धाराखानं कुरु	dhārākhānaṃ kuru	sent.
धिक् अस्तु	dhik astu	sent.
धीवराः मीनम् अनयन्	dhīvarāḥ mīnam anayan	sent.
धुर्यैः व्रजति	dhuryaiḥ vrajati	sent.
धूमपानम् न कर्तव्यम्	dhūmapānam na kartavyam	sent.
धूमपानम् मद्यपानम् च अपायकरे	dhūmapānam madyapānam ca apāyakare	sent.
धूमपानं गतवर्षे एव अहं त्यक्तवान्	dhūmapānaṃ gatavarṣe eva ahaṃ tyaktavān	sent.
धैर्यम् कुरु	dhairyam kuru	sent.
धैर्यं धारय	dhairyaṃ dhāraya	sent.
न, अहं पितरं सूचयामि	na, ahaṃ pitaraṃ sūcayāmi	sent.
न इदं त्वदीयम्	na idaṃ tvadīyam	sent.
न, इदं पुरातनम्	na, idaṃ purātanam	sent.
न, इमी बालकाः विनीतः.	na, imī bālakāḥ vinītaḥ.	sent.
न कथञ्चिद् न	na kathañcid na	phrase
न कदापि त्यजेत्	na kadāpi tyajet	sent.
न किमपि विशेषम्	na kimapi viśeṣam	sent.
न किल ?	na kila ?	sent.
न केवलम् - परन्तु	na kevalam - parantu	phrase
न क्व च	na kva ca	phrase
न क्वचिद्	na kvacid	phrase
न खलु	na khalu	phrase
न खलु तामभिक्रुद्धो गुरुः	na khalu tāmabhikruddho guruḥ	sent.
नगरम् प्रति प्रस्थित	nagaram prati prasthita	sent.
नगरस्य मध्ये	nagarasya madhye	phrase
न चिराद् एव	na cirād eva	phrase
न जाने	na jāne	sent.
न तत् तथा	na tat tathā	sent.
न, तानि नूतनानि.	na, tāni nūtanāni.	sent.
न तावत् उष्णम्	na tāvat uṣṇam	phrase
न तावत् उष्णम् अस्ति	na tāvat uṣṇam asti	sent.
न, त्वदीयम् एव.	na, tvadīyam eva.	sentence
न दृश्यते?	na dṛśyate?	expr.
नपरम् तु	naparam tu	phrase
न, मम सङ्कोचः एव नास्ति	na, mama saṅkocaḥ eva nāsti	sent.
नमस्कारः	namaskāraḥ	expr.
नमस्कारः, आगच्छ.	namaskāraḥ, āgaccha.	sentence
नमस्कारः, कुशलम् किम्?	namaskāraḥ, kuśalam kim?	sentence
नमस्ते	namaste	sent.
नमोनमः	namonamaḥ	sent.
नरव्याघ्रः	naravyāghraḥ	fig.
नवदम्पत्योः वैवाहिकजीवनं सुमधुरं भूयात्	navadampatyoḥ vaivāhikajīvanaṃ sumadhuraṃ bhūyāt	sent.
नवमकक्श्यायां पठामि	navamakakśyāyāṃ paṭhāmi	sent.
नववर्षस्य शुभाशयाः	navavarṣasya  śubhāśayāḥ	sent.
नववर्षं नवचैतन्यं ददातु	navavarṣaṃ navacaitanyaṃ dadātu	sent.
न विस्मरतु	na vismaratu	expr.
न शक्यते भोः	na śakyate bhoḥ	expr.
न सर्वे जनाः स्वार्थिनः	na sarve janāḥ svārthinaḥ	sent.
न, सः गृहे न अस्ति.	na, saḥ gṛhe na asti.	sent.
न हि , आर्य !	na hi , ārya !	phrase
नागराजः अस्ति वा?	nāgarājaḥ asti vā?	sent.
नारङ्गम् आम्रफलात् मधुरतरम्	nāraṅgam āmraphalāt madhurataram	sent.
नासिकां स्वच्छं कृत्वा आगच्छतु	nāsikāṃ svacchaṃ kṛtvā āgacchatu	sent.
नास्ति किल ?	nāsti kila ?	sent.
निघ्न	nighna	suffix
निद्रया आन्दोलनं करोति, पश्यतु	nidrayā āndolanaṃ karoti, paśyatu	sent.
निद्रां करोतु सम्यक् भविष्यति	nidrāṃ karotu samyak bhaviṣyati	sent.
निद्रां कृतवन्तं एतं मा उत्थापयतु	nidrāṃ kṛtavantaṃ etaṃ mā utthāpayatu	sent.
निर्गमनसमयः षड्वादनम् अस्ति	nirgamanasamayaḥ ṣaḍvādanam asti	sent.
निर्वृतिं व्रजति	nirvṛtiṃ vrajati	sent.
निशि निशि	niśi niśi	phrase
निश्चयः नास्ति	niścayaḥ nāsti	expr.
निश्चयः नास्ति	niścayaḥ nāsti	sent.
नैव, अत्रैव सञ्चरामि किल!	naiva, atraiva sañcarāmi kila!	sent.
नैव, इदानीमपि एकाकी	naiva, idānīmapi ekākī	sent.
नैव किल!	naiva kila!	expr.
नैव, गतवर्षे एव क्रीतवती	naiva, gatavarṣe eva krītavatī	sent.
नैव, चिन्ता नास्ति	naiva, cintā nāsti	sent.
नैव, तत्र विवादः एव नास्ति	naiva, tatra vivādaḥ eva nāsti	sent.
नैव, सर्वे विभक्ताः	naiva, sarve vibhaktāḥ	sent.
नैवं वारांतरं विधास्यामि	naivaṃ vārāṃtaraṃ vidhāsyāmi	sent.
नोत्तरं प्रतिभाति मे	nottaraṃ pratibhāti me	sent.
पचने तस्याः कौशलं सर्वत्र प्रसिद्धम्	pacane tasyāḥ kauśalaṃ sarvatra prasiddham	sent.
पञ्चदशदिनाङ्के कः वासरः?	pañcadaśadināṅke kaḥ vāsaraḥ?	sent.
पञ्चनिमेषेषु एतद् कृत्वा ददामि	pañcanimeṣeṣu etad kṛtvā dadāmi	sent.
पञ्चन्यून-दशवादने एव वयं प्रस्थितवन्तः	pañcanyūna-daśavādane eva vayaṃ prasthitavantaḥ	sent.
पञ्चन्यून दशवादने मम घटी स्थगिता	pañcanyūna daśavādane mama ghaṭī sthagitā	sent.
पञ्चभ्यः दिनेभ्यः परम्	pañcabhyaḥ dinebhyaḥ param	phrase
पञ्चभ्यः दिनेभ्यः पूर्वम्	pañcabhyaḥ dinebhyaḥ pūrvam	phrase
पञ्चमी विभक्ति	pañcamī vibhakti	phrase
पञ्चवादनपर्यन्तं अत्रैव आसीत्	pañcavādanaparyantaṃ atraiva āsīt	sent.
पञ्चवादने एकं यानं अस्ति	pañcavādane ekaṃ yānaṃ asti	sent.
पञ्च स्थानकप्रवेशकानि ददातु	pañca sthānakapraveśakāni dadātu	sent.
पञ्च स्यूताः सन्ति	pañca syūtāḥ santi	sent.
पठत संस्कृतम्	paṭhata saṃskṛtam	sent.
पठनवेलायाम् आवधानम् आवश्यकम्	paṭhanavelāyām āvadhānam āvaśyakam	sent.
पठनार्थम् अहं विदेशं गमिष्यामि वा इति प्रपरश्वः ज्ञास्यामि	paṭhanārtham ahaṃ videśaṃ gamiṣyāmi vā iti praparaśvaḥ jñāsyāmi	sent.
पठनीयं बहु अस्ति भोः	paṭhanīyaṃ bahu asti bhoḥ	sent.
पठनं किमपि नास्ति वा?	paṭhanaṃ kimapi nāsti vā?	sent.
पठनं नास्ति, किमपि नास्ति, केवलं अटति	paṭhanaṃ nāsti, kimapi nāsti, kevalaṃ aṭati	sent.
पठन् आसम्	paṭhan āsam	sent.
पठितं किमपि न स्मरामि भोः	paṭhitaṃ kimapi na smarāmi bhoḥ	sent.
पत्नी भोजनम् अपचत्	patnī bhojanam apacat	sent.
पत्रिका पठिता वा? वेतनं वर्धितम्	patrikā paṭhitā vā? vetanaṃ vardhitam	sent.
पत्रिकां तत्रैव अस्तु, सायङ्काले पिता प्रक्ष्यति	patrikāṃ tatraiva astu, sāyaṅkāle pitā prakṣyati	sent.
पदवी अशीतितमे वर्षे समापिता वा?	padavī aśītitame varṣe samāpitā vā?	sent.
पदावी शिक्षणान्तरम्	padāvī śikṣaṇāntaram	phrase
परश्वः विरामः अस्ति वा?	paraśvaḥ virāmaḥ asti vā?	sent.
परह्यः एव दृष्टवान् अहम्	parahyaḥ eva dṛṣṭavān aham	sent.
परह्यः रात्रौ	parahyaḥ rātrau	phrase
परह्यः सः स्नातुमेव न शक्तवान्	parahyaḥ saḥ snātumeva na śaktavān	sent.
परिणाहः बहु न्यूनः	pariṇāhaḥ bahu nyūnaḥ	sent.
परिवर्तं ददातु	parivartaṃ dadātu	sent.
परिवेषणार्थं कियान् विलम्बः?	pariveṣaṇārthaṃ kiyān vilambaḥ?	sent.
परिवेषणं कृतं, शीघ्रं आगच्छतु	pariveṣaṇaṃ kṛtaṃ, śīghraṃ āgacchatu	sent.
परिहासाय उक्तवान् भोः	parihāsāya uktavān bhoḥ	sent.
परीक्षकाणां औदार्यम्	parīkṣakāṇāṃ audāryam	sent.
परीक्षा अग्रे गता	parīkṣā agre gatā	sent.
परीक्षा अन्या, योग्यता अन्या!	parīkṣā anyā, yogyatā anyā!	sent.
परीक्षा कथं आसीत्?	parīkṣā kathaṃ āsīt?	sent.
परीक्षा कदा इति स्मरति किल?	parīkṣā kadā iti smarati kila?	sent.
परीक्षारम्भः कदा इति ज्ञातः वा?	parīkṣārambhaḥ kadā iti jñātaḥ vā?	sent.
परीक्षार्थम् पठ	parīkṣārtham paṭha	sent.
पर्याप्तम्	paryāptam	phrase
पश्य	paśya	sent.
पश्यतु	paśyatu	sent.
पश्यतु, कः शब्दं करोति?	paśyatu, kaḥ śabdaṃ karoti?	sent.
पश्यतु, नासिका स्रवति	paśyatu, nāsikā sravati	sent.
पश्य दिनपत्रिका आगता वा.	paśya dinapatrikā āgatā vā.	sent.
पाकः तदानीं एव सिद्धः	pākaḥ tadānīṃ eva siddhaḥ	sent.
पाकः शीतलं भवति	pākaḥ śītalaṃ bhavati	sent.
पाकः समाप्तः वा?	pākaḥ samāptaḥ vā?	sent.
पाठ्यभागः एव न समाप्तः	pāṭhyabhāgaḥ eva na samāptaḥ	sent.
पादचार	pādacāra	sent.
पादाभ्याम्	pādābhyām	sent.
पादोन षड्वादने भवान् मिलति वा?	pādona ṣaḍvādane bhavān milati vā?	sent.
पानीयं किं ददामि?	pānīyaṃ kiṃ dadāmi?	sent.
पार्श्वगृहं गत्वा पत्रिकां आनयतु	pārśvagṛhaṃ gatvā patrikāṃ ānayatu	sent.
पार्श्वापणे पृच्छतु	pārśvāpaṇe pṛcchatu	sent.
पार्श्वे	pārśve	loc.
पार्श्वं गच्छ !	pārśvaṃ gaccha !	sent.
पाषाणखण्डान् स्वीकृत्य	pāṣāṇakhaṇḍān svīkṛtya	phrase
पितरौ	pitarau	dual
पितरं एकवारं आह्वयतु	pitaraṃ ekavāraṃ āhvayatu	sent.
पितरः पुत्राः च	pitaraḥ putrāḥ ca	expr.
पिता अस्ति, तूष्णीं उपविशन्तु	pitā asti, tūṣṇīṃ upaviśantu	sent.
पिता कुत्र? इदानीम् अपि न आगतवान् वा?	pitā kutra? idānīm api na āgatavān vā?	sent.
पिता भवतीं रेल्स्थानके मेलिष्यति	pitā bhavatīṃ relsthānake meliṣyati	sent.
पिबामि	pibāmi	sent.
पीत्वा शयनं करोतु	pītvā śayanaṃ karotu	sent.
पुत्रैः सह	putraiḥ saha	phrase
पुत्रं लभस्व	putraṃ labhasva	sent.
पुन एकवारं पायसं परिवेषयतु?	puna ekavāraṃ pāyasaṃ pariveṣayatu?	sent.
पुनदर्शनाय	punadarśanāya	phrase
पुनरपि एकवारं प्रयत्नं कुर्मः	punarapi ekavāraṃ prayatnaṃ kurmaḥ	sent.
पुनः अस्माकं मिलनं कदा?	punaḥ asmākaṃ milanaṃ kadā?	sent.
पुनः आगच्छन्तु	punaḥ āgacchantu	sent.
पुनः एकवारं वदतु	punaḥ ekavāraṃ vadatu	sent.
पुनः कदाचित् पश्यामि	punaḥ kadācit paśyāmi	sent.
पुनः कदा मिलति भवान्?	punaḥ kadā milati bhavān?	sent.
पुनः कदा मेलिष्यामः ?	punaḥ kadā meliṣyāmaḥ ?	sent.
पुनः परिवेषयतु	punaḥ pariveṣayatu	sent.
पुनः पुनः अहं पृष्टवती परन्तु भवान् उत्तरमेव न दत्तवान्	punaḥ punaḥ ahaṃ pṛṣṭavatī parantu bhavān uttarameva na dattavān	sent.
पुनः पुनः चर्वणं कृत्वा खादतु	punaḥ punaḥ carvaṇaṃ kṛtvā khādatu	sent.
पुनः मिलामः	punaḥ milāmaḥ	phrase
पुनः मिलामः	punaḥ milāmaḥ	sent.
पुरभवनस्य दक्षिणे भागे	purabhavanasya dakṣiṇe bhāge	sent.
पुरभवनस्य समीपे	purabhavanasya samīpe	phrase
पुरुषव्याघ्रः	puruṣavyāghraḥ	fig.
पुस्तकम् एतस्मिन् स्यूते अस्ति वा इति पश्यतु ।	pustakam etasmin syūte asti vā iti paśyatu |	sent.
पुस्तकानि समाप्तानि	pustakāni samāptāni	sent.
पुस्तकेभ्य एव विद्या न लभेथाः.	pustakebhya eva vidyā na labhethāḥ.	sent.
पूर्वाह्णे षड्वादने	pūrvāhṇe ṣaḍvādane	phrase
पृथुकम्	pṛthukam	sent.
प्रकोपनं विना	prakopanaṃ vinā	phrase
प्रतिदातुं म विस्मरतु	pratidātuṃ ma vismaratu	sent.
प्रतिदिनं प्रबोधामि क्षेत्रेषु च गच्छामि.	pratidinaṃ prabodhāmi kṣetreṣu ca gacchāmi.	sent.
प्रतिप्रभातं विद्यालयं न गच्छामि इति रोदिति	pratiprabhātaṃ vidyālayaṃ na gacchāmi iti roditi	sent.
प्रतिलेखनं प्रत्यानयनं च	pratilekhanaṃ pratyānayanaṃ ca	phrase
प्रतिलेखनं प्रत्याहरणम् च	pratilekhanaṃ pratyāharaṇam ca	phrase
प्रतिवेशी किमर्थं अर्धरात्रसम्ये वीनां वादयति ? उचितसमयं न प्रातवान् किम्?	prativeśī kimarthaṃ ardharātrasamye vīnāṃ vādayati ? ucitasamayaṃ na prātavān kim?	sent.
प्रतिशतं कति अङ्काः प्राप्ताः?	pratiśataṃ kati aṅkāḥ prāptāḥ?	sent.
प्रतिष्ठानस्य कार्यालयः वा?	pratiṣṭhānasya kāryālayaḥ vā?	sent.
प्रत्यागच्छसि	pratyāgacchasi	sent.
प्रत्यागच्छामि	pratyāgacchāmi	sent.
प्रत्युत्तरं न वदतु	pratyuttaraṃ na vadatu	sent.
प्रथमम् अर्धचषकमितं जलं चुल्लिकायाः उपरि सम्यक् क्वथयतु	prathamam ardhacaṣakamitaṃ jalaṃ cullikāyāḥ upari samyak kvathayatu	sent.
प्रथमम् सः पुष्पानि तां दास्यति	prathamam saḥ puṣpāni tāṃ dāsyati	sent.
प्रथमा विभक्ति	prathamā vibhakti	phrase
प्रथमं शिरोमार्जनं करोतु	prathamaṃ śiromārjanaṃ karotu	sent.
प्रथमः कः? सः वा भवान् वा?	prathamaḥ kaḥ? saḥ vā bhavān vā?	sent.
प्रमादतः संवृत्तम्, न तु बुद्ध्या	pramādataḥ saṃvṛttam, na tu buddhyā	sent.
प्रयत्नं करोमि	prayatnaṃ karomi	expr.
प्रवासे व्यवस्था समीचीना आसीत् वा?	pravāse vyavasthā samīcīnā āsīt vā?	sent.
प्रवेशपत्रं स्वीकृतं वा?	praveśapatraṃ svīkṛtaṃ vā?	sent.
प्रश्न पत्रिका किञ्चित् क्लिष्टा आसीत्	praśna patrikā kiñcit kliṣṭā āsīt	sent.
प्रश्नपत्रिका सज्जीकृता वा?	praśnapatrikā sajjīkṛtā vā?	sent.
प्रश्नाः उत्तराणि च	praśnāḥ uttarāṇi ca	phrase
प्रश्नेषु विकल्पः एव नासीत्	praśneṣu vikalpaḥ eva nāsīt	sent.
प्रसीदतु भवान्	prasīdatu bhavān	sent.
प्राङ्गणे मम अश्वद्वयम् अस्ति	prāṅgaṇe mama aśvadvayam asti	sent.
प्राचार्यस्य आदेशं दृष्टवान् वा?	prācāryasya ādeśaṃ dṛṣṭavān vā?	sent.
प्राचार्यः आगतः वा?	prācāryaḥ āgataḥ vā?	sent.
प्रातराशं करोमि	prātarāśaṃ karomi	sent.
प्रातः आरभ्य एवमेव वृष्टिः	prātaḥ ārabhya evameva vṛṣṭiḥ	sent.
प्रातः आरभ्य लघु शिरोवेदना	prātaḥ ārabhya laghu śirovedanā	sent.
प्रातः किञ्चित् शीघ्रं गन्तव्यम् । नो चेत् वयं सरोवरं समये न प्राप्स्यामः	prātaḥ kiñcit śīghraṃ gantavyam | no cet vayaṃ sarovaraṃ samaye na prāpsyāmaḥ	sent.
प्रातः भ्रमणं कुरु	prātaḥ bhramaṇaṃ kuru	sent.
प्रायशः द्वितीयश्रेणी लभ्येत	prāyaśaḥ dvitīyaśreṇī labhyeta	sent.
प्रायः तथा न स्यात्	prāyaḥ tathā na syāt	sent.
प्रायः सर्वे	prāyaḥ sarve	phrase
प्रेषणालयस्य पुरतः	preṣaṇālayasya purataḥ	expr.
फलकमपि नास्ति, किमपि नास्ति	phalakamapi nāsti, kimapi nāsti	sent.
फलितांशः श्वः ज्ञातः भविष्यति	phalitāṃśaḥ śvaḥ jñātaḥ bhaviṣyati	sent.
फेनकस्य मूल्यं कियत्?	phenakasya mūlyaṃ kiyat?	sent.
बटु लभते उपवीतम् उपनयन-संस्कारे	baṭu labhate upavītam upanayana-saṃskāre	sent.
बन्धने निरुद्ध	bandhane niruddha	expr.
बन्धनं भित्त्वा पलायाञ्चक्रे	bandhanaṃ bhittvā palāyāñcakre	expr.
बहवः उद्योगिनः अद्य विरामं स्वीकुर्वन्तः । कृपया बुधवासरे दूरवाणीं करोतु	bahavaḥ udyoginaḥ adya virāmaṃ svīkurvantaḥ | kṛpayā budhavāsare dūravāṇīṃ karotu	sent.
बहवः धन्यवादाः	bahavaḥ dhanyavādāḥ	sent.
बहिर् गच्छ	bahir gaccha	sent.
बहिः अन्धकारः, करदीपं गृहीत्वा गच्छतु	bahiḥ andhakāraḥ, karadīpaṃ gṛhītvā gacchatu	sent.
बहिः गतवान् , इदानीं आगच्छति	bahiḥ gatavān , idānīṃ āgacchati	sent.
बहु औष्ण्यं किल?	bahu auṣṇyaṃ kila?	sent.
बहुकालतः तस्य वार्ता एव नास्ति	bahukālataḥ tasya vārtā eva nāsti	sent.
बहुकालतः प्रतीक्षां करोमि	bahukālataḥ pratīkṣāṃ karomi	sent.
बहु जल्पति भोः	bahu jalpati bhoḥ	sent.
बहु दूरे अस्ति किम् ?	bahu dūre asti kim ?	sent.
बहुदूरे अस्ति वा?	bahudūre asti vā?	sent.
बहुधा श्रान्तः अस्मि भोः	bahudhā śrāntaḥ asmi bhoḥ	sent.
बहु पूर्वमेव	bahu pūrvameva	phrase
बहु पूर्वमेव पठितवान्	bahu pūrvameva paṭhitavān	sent.
बहु मधुरम्	bahu madhuram	sent.
बहु श्रान्तः अस्मि	bahu śrāntaḥ asmi	sent.
बहु सम्यक् अस्ति	bahu samyak asti	sent.
बहु सुन्दरं अस्ति किल एतद् ?	bahu sundaraṃ asti kila etad ?	sent.
बहोः कालात्	bahoḥ kālāt	phrase
बहोः कालात् पूर्वम्	bahoḥ kālāt pūrvam	phrase
बालकाः सन्ति	bālakāḥ santi	sent.
बालकः लिखतु	bālakaḥ likhatu	sentence
बालिका किमपि आवश्यकं इति वदति स्म	bālikā kimapi āvaśyakaṃ iti vadati sma	sent.
बालिका वानरान् फलानि यच्छति	bālikā vānarān phalāni yacchati	sent.
बालिकाः वानरेभ्यः फलानि ददति	bālikāḥ vānarebhyaḥ phalāni dadati	sent.
बुद्धिमान् विवेकी सन् अपि भवान् किमर्थम् एतत् अवगन्तुं न शक्तवान् ?	buddhimān vivekī san api bhavān kimartham etat avagantuṃ na śaktavān ?	sent.
बुभुक्षा भवम्यहम्	bubhukṣā bhavamyaham	sent.
बेङ्गलूरुनगरे वायुगुणः कीदृशः ?	beṅgalūrunagare vāyuguṇaḥ kīdṛśaḥ ?	sent.
भगिनी, मम कृते गणितं पाठयति वा?	bhaginī, mama kṛte gaṇitaṃ pāṭhayati vā?	sent.
भद्रं वर्तस्व	bhadraṃ vartasva	sent.
भयस्य कारणं नास्ति	bhayasya kāraṇaṃ nāsti	sent.
भयं मास्तु	bhayaṃ māstu	sent.
भरतः लक्ष्मणात् पूर्वः	bharataḥ lakṣmaṇāt pūrvaḥ	sent.
भवता अपि संस्कृतभाषायां वक्तुं शक्यते इति अहं न ज्ञातवान् । अत्त्युत्तमं भोः	bhavatā api saṃskṛtabhāṣāyāṃ vaktuṃ śakyate iti ahaṃ na jñātavān | attyuttamaṃ bhoḥ	sent.
भवता एतद् न कर्तव्यम्	bhavatā etad na kartavyam	sent.
भवता एव वक्तव्यम्	bhavatā eva vaktavyam	sent.
भवता तत् युतकं न समीकरणीयम् । तत् नाशं भविष्यति	bhavatā tat yutakaṃ na samīkaraṇīyam | tat nāśaṃ bhaviṣyati	sent.
भवताम् मित्राणि	bhavatām mitrāṇi	phrase
भवता वक्तव्यं आसीत् किल?	bhavatā vaktavyaṃ āsīt kila?	sent.
भवती अध्यपिका	bhavatī adhyapikā	sent.
भवती अनन्तरं उपविशतु	bhavatī anantaraṃ upaviśatu	sent.
भवती का इति अहम् अभिज्ञातुं न शक्तवान् । अतः एवं जातम् ।	bhavatī kā iti aham abhijñātuṃ na śaktavān | ataḥ evaṃ jātam |	sent.
भवती काञ्चित् भारतीयभाषां जानाति चेत् संस्कृतं बहु सुलभम् एव	bhavatī kāñcit bhāratīyabhāṣāṃ jānāti cet saṃskṛtaṃ bahu sulabham eva	sent.
भवती किं (उद्योगं) करोति?	bhavatī kiṃ (udyogaṃ) karoti?	sent.
भवती पक्तुं एव न जानाति अम्ब!	bhavatī paktuṃ eva na jānāti amba!	sent.
भवती बहु पठति, जानामि	bhavatī bahu paṭhati, jānāmi	sent.
भवती भागं गृह्णाति किम्	bhavatī bhāgaṃ gṛhṇāti kim	sent.
भवती मां परिणेष्यति किम् ?	bhavatī māṃ pariṇeṣyati kim ?	sent.
भवतीषु का अञ्जली?	bhavatīṣu kā añjalī?	sent.
भवतु!	bhavatu!	expr.
भवतु	bhavatu	sent.
भवतु, चिन्तां न करोतु	bhavatu, cintāṃ na karotu	sent.
भवतु नाम	bhavatu nāma	expr.
भवतो माता किं करोति स्म?	bhavato mātā kiṃ karoti sma?	sent.
भवतः अनुजायाः कति वर्षाणि?	bhavataḥ anujāyāḥ kati varṣāṇi?	sent.
भवतः अभिप्रायः कः?	bhavataḥ abhiprāyaḥ kaḥ?	sent.
भवतः आकाशवाणी समयः वा?	bhavataḥ ākāśavāṇī samayaḥ vā?	sent.
भवतः का हानिः ?	bhavataḥ kā hāniḥ ?	sent.
भवतः किं कष्टं अस्ति?	bhavataḥ kiṃ kaṣṭaṃ asti?	sent.
भवतः कृते इति न्यूनमूल्येन ददामि	bhavataḥ kṛte iti nyūnamūlyena dadāmi	sent.
भवतः कृते कथनापेक्षया स्वयं करणं वरम्	bhavataḥ kṛte kathanāpekṣayā svayaṃ karaṇaṃ varam	sent.
भवतः कृते कः उक्तवान्?	bhavataḥ kṛte  kaḥ uktavān?	sent.
भवतः कृते दूरवाणी आगता आसीत्	bhavataḥ kṛte dūravāṇī āgatā āsīt	sent.
भवतः गृहं कुत्र अस्ति ?	bhavataḥ gṛhaṃ kutra asti ?	sent.
भवतः ग्रामः?	bhavataḥ grāmaḥ?	sent.
भवतः जन्मदिनाङ्कः कः?	bhavataḥ janmadināṅkaḥ kaḥ?	sent.
भवतः पत्रं इदानीं एव लब्धम्	bhavataḥ patraṃ idānīṃ eva labdham	sent.
भवतः परिचयः एव न लब्धः	bhavataḥ paricayaḥ eva na labdhaḥ	sent.
भवतः परीवृत्तिः कथमस्ति?	bhavataḥ parīvṛttiḥ kathamasti?	sent.
भवतः पिता कुत्र कार्यं करोति?	bhavataḥ pitā kutra kāryaṃ karoti?	sent.
भवतः प्रदेशे वृष्टिः कथम्?	bhavataḥ pradeśe vṛṣṭiḥ katham?	sent.
भवतः मित्रं अहं मिलितवान्	bhavataḥ mitraṃ ahaṃ militavān	sent.
भवतः लेखनी कुत्र?	bhavataḥ lekhanī kutra?	sent.
भवतः लेखा कुत्र अस्ति ?	bhavataḥ lekhā kutra asti ?	sent.
भवतः वचनम् सत्यम्	bhavataḥ vacanam satyam	sent.
भवतः वचनं सत्यम्	bhavataḥ vacanaṃ satyam	sent.
भवतः वयः कियत् ?	bhavataḥ vayaḥ kiyat ?	sent.
भवतः वर्गशिक्षकः कः?	bhavataḥ vargaśikṣakaḥ kaḥ?	sent.
भवतः वेतनश्रेणी का?	bhavataḥ vetanaśreṇī kā?	sent.
भवतः वैवाहिकजीवनं शुभमयं भवतु	bhavataḥ vaivāhikajīvanaṃ śubhamayaṃ bhavatu	sent.
भवतः शाला कदा आरब्धा?	bhavataḥ śālā kadā ārabdhā?	sent.
भवतः सङ्केतं एव न जानामि स्म	bhavataḥ saṅketaṃ eva na jānāmi sma	sent.
भवतः समयावकाशः अस्ति वा?	bhavataḥ samayāvakāśaḥ asti vā?	sent.
भवतः समीपे सम्भाषणीयं अस्ति	bhavataḥ samīpe sambhāṣaṇīyaṃ asti	sent.
भवतः सर्वं अहं जानामि	bhavataḥ sarvaṃ ahaṃ jānāmi	sent.
भवतः सौकर्यं मनसिकृत्य एव एवं मया कृतम्	bhavataḥ saukaryaṃ manasikṛtya eva evaṃ mayā kṛtam	sent.
भवत्याः गृहं कश्चिद् आगत इव	bhavatyāḥ gṛhaṃ kaścid āgata iva	sent.
भवत्याः शाटिका नूतना वा?	bhavatyāḥ śāṭikā nūtanā vā?	sent.
भवत्यः विद्यार्थिन्यः	bhavatyaḥ vidyārthinyaḥ	sent.
भवत्सु कः विमानचालनं जानाति ?	bhavatsu kaḥ vimānacālanaṃ jānāti ?	sent.
भवदीयः समारम्भः यशस्वी भवतु	bhavadīyaḥ samārambhaḥ yaśasvī bhavatu	sent.
भवदुक्तं सर्वमपि अङ्गीकर्तुं न शक्यम्	bhavaduktaṃ sarvamapi aṅgīkartuṃ na śakyam	sent.
भवदुक्तं सर्वं ज्ञातवान् भोः	bhavaduktaṃ sarvaṃ jñātavān bhoḥ	sent.
भवन् किम् किम् करिष्यति ?	bhavan kim kim kariṣyati ?	sent.
भवन् तत्र कदा गच्छति?	bhavan tatra kadā gacchati?	sent.
भवन्तम्	bhavantam	acc.
भवन्तु	bhavantu	v.
भवन्तं कुत्रापि दृष्टवान्	bhavantaṃ kutrāpi dṛṣṭavān	sent.
भवन्तं गृहे एव पश्यामि	bhavantaṃ gṛhe eva paśyāmi	sent.
भवन्तं दृष्टुं सः पुनः आगच्छति किल?	bhavantaṃ dṛṣṭuṃ saḥ punaḥ āgacchati kila?	sent.
भवन्तं बहु प्रतीक्षितवान्	bhavantaṃ bahu pratīkṣitavān	sent.
भवन्तः कति सहोदराः?	bhavantaḥ kati sahodarāḥ?	sent.
भवन्तः किल मास्तु इति उक्तवन्तः	bhavantaḥ kila māstu iti uktavantaḥ	sent.
भवन्तः शिक्षकाः	bhavantaḥ śikṣakāḥ	sent.
भवन्तः सर्वे सहैव वसन्ति वा?	bhavantaḥ sarve sahaiva vasanti vā?	sent.
भवान् अधिकं मूल्यं दत्तवान्	bhavān adhikaṃ mūlyaṃ dattavān	sent.
भवान् अन्यथा गृहीतवान्	bhavān anyathā gṛhītavān	sent.
भवान् अपि अङ्गीकरोति वा?	bhavān api aṅgīkaroti vā?	sent.
भवान् अपि एवं वदति वा?	bhavān api evaṃ vadati vā?	sent.
भवान् अपि विश्वासं कृतवान्?	bhavān api viśvāsaṃ kṛtavān?	sent.
भवान् आरक्षणं कृतवान् वा?	bhavān ārakṣaṇaṃ kṛtavān vā?	sent.
भवान् एकत्र स्थापयति अन्यत्र अन्वेषणं करोति । किमर्थं इति पृच्छामि चेत् भवान् कुप्यति	bhavān ekatra sthāpayati  anyatra anveṣaṇaṃ karoti | kimarthaṃ iti pṛcchāmi cet bhavān kupyati	sent.
भवान् एतादृशीं गतिं प्रापयेत् इति मया स्वप्ने अपि न चिन्तितम् आसीत्	bhavān etādṛśīṃ gatiṃ prāpayet iti mayā svapne api na cintitam āsīt	sent.
भवान् एव किम् ?	bhavān eva kim ?	sent.
भवान् एव ज्येष्ठः वा?	bhavān eva jyeṣṭhaḥ vā?	sent.
भवान् एव परिशीलयतु	bhavān eva pariśīlayatu	sent.
भवान् एव वा! दूरतः न ज्ञातम्	bhavān eva vā! dūrataḥ na jñātam	sent.
भवान् एवं कर्तुं अर्हति वा?	bhavān evaṃ kartuṃ arhati vā?	sent.
भवान् कति दिनानि विरामं स्वीकरोति?	bhavān kati dināni virāmaṃ svīkaroti?	sent.
भवान् कथम् अजानात् ?	bhavān katham ajānāt ?	sent.
भवान् कथम् रक्षितः ?	bhavān katham rakṣitaḥ ?	sent.
भवान् कथं रक्षितः ?	bhavān kathaṃ rakṣitaḥ ?	sent.
भवान् कन्दुकं ददाति चेत् सः तं ग्रहीष्यति	bhavān kandukaṃ dadāti cet saḥ taṃ grahīṣyati	sent.
भवान् कस्मिन् स्थाने नियुक्तः अस्ति?	bhavān kasmin sthāne niyuktaḥ asti?	sent.
भवान् काफीं पिबति उत चायम्?	bhavān kāphīṃ pibati uta cāyam?	sent.
भवान् किमपि न खादितवान्?	bhavān kimapi na khāditavān?	sent.
भवान् किं (उद्योगं) करोति?	bhavān kiṃ (udyogaṃ) karoti?	sent.
भवान् किं करोति ?	bhavān kiṃ karoti ?	sent.
भवान् किं पठति ?	bhavān kiṃ paṭhati ?	sent.
भवान् कुतः आगच्छति?	bhavān kutaḥ āgacchati?	sent.
भवान् कुत्र गच्छति ?	bhavān kutra gacchati ?	sent.
भवान् कुत्र वसति ?	bhavān kutra vasati ?	sent.
भवान् क्रिदाङ्गने क्रीडति	bhavān kridāṅgane krīḍati	sent.
भवान् गच्छतु, मम किञ्चित् कार्यं अस्ति	bhavān gacchatu, mama kiñcit kāryaṃ asti	sent.
भवान् ज्ञातवान् वा? वदतु किञ्चित्	bhavān jñātavān vā? vadatu kiñcit	sent.
भवान् धीमान् / कुशलः बालः	bhavān dhīmān / kuśalaḥ bālaḥ	sent.
भवान् न उक्तवान् एव	bhavān na uktavān eva	sent.
भवान् बालकः	bhavān bālakaḥ	sent.
भवान् / भवती कस्यां कक्ष्यायां पठति?	bhavān / bhavatī kasyāṃ kakṣyāyāṃ paṭhati?	sent.
भवान् (भवती) कुतः आगच्छति?	bhavān (bhavatī) kutaḥ āgacchati?	sent.
भवान् / भवती कुत्र गच्छति?	bhavān / bhavatī kutra gacchati?	sent.
भवान् भीरुः किम् ?	bhavān bhīruḥ kim ?	sent.
भवान् मम अपेक्षया ज्येष्ठः वा?	bhavān mama apekṣayā jyeṣṭhaḥ vā?	sent.
भवान् मा ददातु, मा स्वीकरोतु	bhavān mā dadātu, mā svīkarotu	sent.
भवान् रविवासरे किम् करोति ?	bhavān ravivāsare kim karoti ?	sent.
भवान् विवाहितः वा?	bhavān vivāhitaḥ vā?	sent.
भवान् शीघ्रं न गच्छति चेत् यानं न मिलति	bhavān śīghraṃ na gacchati cet yānaṃ na milati	sent.
भवान् शीघ्रं प्रत्यागच्छति वा?	bhavān śīghraṃ pratyāgacchati vā?	sent.
भवान् सम्भाषणशिबिरं आगतवान् वा?	bhavān sambhāṣaṇaśibiraṃ āgatavān vā?	sent.
भवान् स्वकार्यं पश्यतु	bhavān svakāryaṃ paśyatu	sent.
भाजकः	bhājakaḥ	arithm.
भाण्डे जलं अस्ति वा?	bhāṇḍe jalaṃ asti vā?	sent.
भारतस्य उत्तरे भागे	bhāratasya uttare bhāge	phrase
भारतस्य दक्षिणे भागे	bhāratasya dakṣiṇe bhāge	phrase
भारतस्य दक्षिने	bhāratasya dakṣine	sent.
भारतस्य पश्चिमे भागे	bhāratasya paścime bhāge	phrase
भारवाहाः भारम् अवहन्	bhāravāhāḥ bhāram avahan	sent.
भिन्नेषु गृहेषु	bhinneṣu gṛheṣu	phrase
भीतिः मास्तु	bhītiḥ māstu	sent.
भीमः दुर्योधनाय अलम्	bhīmaḥ duryodhanāya alam	sent.
भोजनम् आनय	bhojanam ānaya	sent.
भोजनसमये आह्वयामि, इदानीं गच्छतु	bhojanasamaye āhvayāmi, idānīṃ gacchatu	sent.
भोजनान्तरं गच्छतु	bhojanāntaraṃ gacchatu	sent.
भोजनार्थं कोऽपि विशेषः?	bhojanārthaṃ ko pi viśeṣaḥ?	sent.
भोजनं अभवत् वा?	bhojanaṃ abhavat vā?	sent.
भोजनं कृत्वा निद्रां करोतु	bhojanaṃ kṛtvā nidrāṃ karotu	sent.
भोजनं सम्यक् करोति चेत् भवतीं क्रीडनकं ददामि	bhojanaṃ samyak karoti cet bhavatīṃ krīḍanakaṃ dadāmi	sent.
भोजनं सिद्धं वा? शालायाः विलम्बः भवति	bhojanaṃ siddhaṃ vā? śālāyāḥ vilambaḥ bhavati	sent.
भो वणिक्	bho vaṇik	phrase
भो वणिक्	bho vaṇik	sent.
भोः, आनीतवान् वा ?	bhoḥ, ānītavān vā ?	sent.
भ्वत्याः एतद् युज्यते	bhvatyāḥ etad yujyate	sent.
मकरसङ्क्रमणस्य / पोङ्गल् शुभाशयाः	makarasaṅkramaṇasya / poṅgal śubhāśayāḥ	sent.
मण्डूकोनुवत्ति	maṇḍūkonuvatti	fig.
म तावत्	ma tāvat	phrase
मत्कुणो मत्कुणः	matkuṇo matkuṇaḥ	sent.
मत्तः स्वीकृतम् ऋणं प्रत्यर्पयतु	mattaḥ svīkṛtam ṛṇaṃ pratyarpayatu	sent.
मद्रासतः इदानीमपि न आगतवान्	madrāsataḥ idānīmapi na āgatavān	sent.
मधुरं नाम	madhuraṃ nāma	phrase
मध्यरात्रकारणेन वीथीषु इतस्ततः सञ्चरन् कोऽपि न दृष्टः	madhyarātrakāraṇena vīthīṣu itastataḥ sañcaran ko pi na dṛṣṭaḥ	sent.
मध्याह्ने	madhyāhne	loc.
मध्ये	madhye	loc.
मध्ये सम्भाषणं न करोतु!	madhye sambhāṣaṇaṃ na karotu!	sent.
मन्द अपसारी श्रेणी	manda apasārī śreṇī	phrase
मन्दं वद	mandaṃ vada	sent.
मन्ये	manye	sent.
मम अक्षराणि न सुन्दराणि	mama akṣarāṇi na sundarāṇi	sent.
मम अन्यत् कार्यम् अस्ति	mama anyat kāryam asti	sent.
मम अपत्यानि त्रीणि.	mama apatyāni trīṇi.	sent.
मम आरोग्यं समीचीनं नास्ति	mama ārogyaṃ samīcīnaṃ nāsti	sent.
मम एकः अग्रजः अस्ति	mama ekaḥ agrajaḥ asti	sent.
मम एतेषां प्रश्नानाम् उत्तरं यदि भवान् जानन् अपि न वदेत् तर्हि भवतः शिरः सहस्रधा भग्नं भवेत् अचिरात् एव !	mama eteṣāṃ praśnānām uttaraṃ yadi bhavān jānan api na vadet tarhi bhavataḥ śiraḥ sahasradhā bhagnaṃ bhavet acirāt eva !	sent.
मम कार्यं न समाप्तम्	mama kāryaṃ na samāptam	sent.
मम किमपि क्लेशः नास्ति	mama kimapi kleśaḥ nāsti	sent.
मम कृते काऽपि दूरवाणी आगता वा?	mama kṛte kā pi dūravāṇī āgatā vā?	sent.
मम केवलं भ्रातास्ति.	mama kevalaṃ bhrātāsti.	sent.
मम गृहपाठः बहु अस्ति	mama gṛhapāṭhaḥ bahu asti	sent.
मम गृहे	mama gṛhe	phrase
मम ग्रामः	mama grāmaḥ	expr.
मम घटी निमेषद्वयं अग्रे सरति	mama ghaṭī nimeṣadvayaṃ agre sarati	sent.
मम छत्रं भवान् किमर्थं स्वीकृतवान्?	mama chatraṃ bhavān kimarthaṃ svīkṛtavān?	sent.
मम छात्राः बीजगणितं जानन्ति	mama chātrāḥ bījagaṇitaṃ jānanti	sent.
मम तु आक्शेपः नास्ति	mama tu ākśepaḥ nāsti	sent.
मम तु इदानीं अतीव बुभुक्षा	mama tu idānīṃ atīva bubhukṣā	sent.
मम त्रयः पुत्राः सन्ति.	mama trayaḥ putrāḥ santi.	sent.
मम दूरभाषसङ्ख्याम् जानाति	mama dūrabhāṣasaṅkhyām jānāti	sent.
मम द्विचक्रिकां पश्य	mama dvicakrikāṃ paśya	sent.
मम नाम मोहिनी	mama nāma mohinī	sent.
मम नूतनं वाहनम्	mama nūtanaṃ vāhanam	sent.
मम पत्रं प्राप्तवान् किम् ?	mama patraṃ prāptavān kim ?	sent.
मम बहु सन्तोषः भवति.	mama bahu santoṣaḥ bhavati.	sent.
मम भ्राता जीवितसंशये वर्तते	mama bhrātā jīvitasaṃśaye vartate	sent.
मम माता आवश्यकी इति प्रतिदिनम् सः रुदितवान्	mama mātā āvaśyakī iti pratidinam saḥ ruditavān	sent.
मम मित्रत्रयेण सह चलनचित्रमन्दिरम् गतवान् आसम्	mama mitratrayeṇa saha calanacitramandiram gatavān āsam	sent.
मम मित्रं लेखिष्यति	mama mitraṃ lekhiṣyati	sent.
मम लेखनीं स्वीकृतवान् वा?	mama lekhanīṃ svīkṛtavān vā?	sent.
मम लेखस्योत्तरं प्रहिणु-प्रेषय	mama lekhasyottaraṃ prahiṇu-preṣaya	sent.
मम वचनं कः शृणोति?	mama vacanaṃ kaḥ śṛṇoti?	sent.
मम वचनं शृणोतु	mama vacanaṃ śṛṇotu	sent.
मम वमनशङ्का	mama vamanaśaṅkā	sent.
मम व्यवहारं समापयतु	mama vyavahāraṃ samāpayatu	sent.
मम शिक्षकः एवं एव पाठितवान्	mama śikṣakaḥ evaṃ eva pāṭhitavān	sent.
मम शिरः भ्रमति इव	mama śiraḥ bhramati iva	sent.
मम शेषम् अस्ति	mama śeṣam asti	sent.
मम हस्तं धर!	mama hastaṃ dhara!	sent.
ममापि बहुनि कार्याणि सन्ति	mamāpi bahuni kāryāṇi santi	sent.
मया अन्यत्र गन्तव्यम्	mayā anyatra gantavyam	sent.
मया किं करणीयं, वदतु	mayā kiṃ karaṇīyaṃ, vadatu	sent.
मया गन्तव्यम्	mayā gantavyam	sent.
मया तवानुचरेण भवितव्यम्	mayā tavānucareṇa bhavitavyam	sent.
मयापि एकवारं द्रष्टव्यम्	mayāpi ekavāraṃ draṣṭavyam	sent.
मया मद्यपानं त्यक्तव्यम् इति मम वैद्यः वदति स्म.	mayā madyapānaṃ tyaktavyam iti mama vaidyaḥ vadati sma.	sent.
मया सदृशः कः अन्यः अस्ति ?	mayā sadṛśaḥ kaḥ anyaḥ asti ?	sent.
मया सह	mayā saha	phrase
मल्लेश्वरयानस्य का सङ्ख्या?	malleśvarayānasya kā saṅkhyā?	sent.
मल्लेश्वरं गन्तुं कः मार्गः?	malleśvaraṃ gantuṃ kaḥ mārgaḥ?	sent.
मशकजालः कुत्र?	maśakajālaḥ kutra?	sent.
मशको मशकः!	maśako maśakaḥ!	sent.
महती घोरिका भोः महारावस्य	mahatī ghorikā bhoḥ mahārāvasya	sent.
महती पादवेदना	mahatī pādavedanā	sent.
महती वृष्टिः	mahatī vṛṣṭiḥ	sent.
महद् अद्भुतम्	mahad adbhutam	sent.
महाजनः संवृत्तः भवान्!	mahājanaḥ saṃvṛttaḥ bhavān!	sent.
महान् कोलाहलः इति श्रुतवान्	mahān kolāhalaḥ iti śrutavān	sent.
महान् जनसम्मर्दः	mahān janasammardaḥ	sent.
महान् सन्तोषः	mahān santoṣaḥ	expr.
महान् सम्मर्दः आसीत्	mahān sammardaḥ āsīt	sent.
महाभरते अनेकाः कथाः विद्यन्ते	mahābharate anekāḥ kathāḥ vidyante	sent.
महिलाः श्लोकम् अगायन्	mahilāḥ ślokam agāyan	sent.
मह्यं किञ्चित् चायं कुरु	mahyaṃ kiñcit cāyaṃ kuru	sent.
मातुलगृहे	mātulagṛhe	loc.
मातः दन्तकूर्चः कुत्र ?	mātaḥ dantakūrcaḥ kutra ?	sent.
मादृशः एव मम पुत्रः	mādṛśaḥ eva mama putraḥ	sent.
मा नाम अकास्यं कुर्यात्	mā nāma akāsyaṃ kuryāt	sent.
माम् धिक् अस्तु	mām dhik astu	sent.
मार्गमध्ये अपघातः अभवत्	mārgamadhye apaghātaḥ abhavat	sent.
मार्गे दुर्घटना अभवत्	mārge durghaṭanā abhavat	sent.
मार्गे सौचिकं विचार्य गच्छन्तु	mārge saucikaṃ vicārya gacchantu	sent.
मार्जारः मूषकम् अपश्यत्	mārjāraḥ mūṣakam apaśyat	sent.
मासे कति चित्राणि पश्यति?	māse kati citrāṇi paśyati?	sent.
मास्तु, अधिकं भवति	māstu, adhikaṃ bhavati	sent.
मास्तु इत्युक्तेऽपि सः न शृणोति	māstu ityukte pi saḥ na śṛṇoti	sent.
मास्तु, मास्तु	māstu, māstu	sent.
मास्तु, यथेष्टं अभवत्	māstu, yatheṣṭaṃ abhavat	sent.
मां आहूतवान् वा?	māṃ āhūtavān vā?	sent.
मां किञ्चित् स्मारयतु	māṃ kiñcit smārayatu	sent.
मां न कोपयतु	māṃ na kopayatu	sent.
मित्रैः सह	mitraiḥ saha	phrase
मित्रैः सः	mitraiḥ saḥ	phrase
मिलित्वा गच्छामः	militvā gacchāmaḥ	sent.
मुखं संवर	mukhaṃ saṃvara	sent.
मुम्बयीतः मम अग्रजः आनीतवान्	mumbayītaḥ mama agrajaḥ ānītavān	sent.
मूढ !	mūḍha !	sent.
मृतसमुद्रः अन्यसमुद्राणां तुलनया दशगुणम् अधिकः क्षारः	mṛtasamudraḥ anyasamudrāṇāṃ tulanayā daśaguṇam adhikaḥ kṣāraḥ	sent.
मृत्तैलं लब्धं वा?	mṛttailaṃ labdhaṃ vā?	sent.
मृत्तैलं विक्रीयते इति श्रुतवती	mṛttailaṃ vikrīyate iti śrutavatī	sent.
मृदु वद	mṛdu vada	sent.
मेलनेन बहु सन्तोषः	melanena bahu santoṣaḥ	sentence
मेल्लिस्सा चमसमितां शर्करां जलेन योजितवती	mellissā camasamitāṃ śarkarāṃ jalena yojitavatī	sent.
मोहनः अद्य चलचित्र मन्दिरे अस्ति.	mohanaḥ adya calacitra mandire asti.	sent.
मौनमेव उचितम्	maunameva ucitam	sent.
मौल्यमापनार्थं गच्छति वा?	maulyamāpanārthaṃ gacchati vā?	sent.
मौल्यमापनं कुत्र?	maulyamāpanaṃ kutra?	sent.
म्रियस्व !	mriyasva !	sent.
यत्किमपि भवतु	yatkimapi bhavatu	expr.
यत्र तत्रापि	yatra tatrāpi	phrase
यत्र धूमः तत्र वह्निः	yatra dhūmaḥ tatra vahniḥ	sent.
यत्र भक्तः तत्र भगवान्	yatra bhaktaḥ tatra bhagavān	sent.
यथा कथञ्चित्	yathā kathañcit	phrase
यथा पिता तथा पुत्रः.	yathā pitā tathā putraḥ.	sent.
यथा भवते रोचते	yathā bhavate rocate	sent.
यथा भवान् इच्छति	yathā bhavān icchati	sent.
यथा भवान् इच्छति तथा	yathā bhavān icchati tathā	sent.
यथाभिलषितं क्रियतम्	yathābhilaṣitaṃ kriyatam	sent.
यथार्थं वदामि	yathārthaṃ vadāmi	sent.
यथावत्	yathāvat	sent.
यथेष्टम् अस्ति	yatheṣṭam asti	sent.
यथेष्टं अस्ति	yatheṣṭaṃ asti	sent.
यदभिरोचते वयस्याय	yadabhirocate vayasyāya	expr.
यदा इच्छसि तदा यथेष्टकाले आगच्छ	yadā icchasi tadā yatheṣṭakāle āgaccha	sent.
यदा कदा वा भवतु, अहं सिद्धः	yadā kadā vā bhavatu, ahaṃ siddhaḥ	sent.
यदा सः अन्तः गतवान् तदा चतस्रः महिलाः मधुरं गायन्त्यः आसन्	yadā saḥ antaḥ gatavān tadā catasraḥ mahilāḥ madhuraṃ gāyantyaḥ āsan	sent.
यदा सः मम स्वरं शृणोति तदा मम कुक्कुरः उपवेक्ष्यति	yadā saḥ mama svaraṃ śṛṇoti tadā mama kukkuraḥ upavekṣyati	sent.
यदा स्वनाम श्रुतवान् तदा सः झटिति उत्थितवान्	yadā svanāma śrutavān tadā saḥ jhaṭiti utthitavān	sent.
यदि न रोचते, न आगच्छ	yadi na rocate, na āgaccha	sent.
यदि भवान् न पठति तर्हि परीक्षायाम् उत्तीर्णः नो भवति	yadi bhavān na paṭhati tarhi parīkṣāyām uttīrṇaḥ no bhavati	sent.
यदि लोकयानं वेगेन न गच्छति तर्हि समये तत्र न प्राप्नुमः	yadi lokayānaṃ vegena na gacchati tarhi samaye tatra na prāpnumaḥ	sent.
यदि विद्युत् अस्ति तर्हि दीपः ज्वलति	yadi vidyut asti tarhi dīpaḥ jvalati	sent.
यदि सः स्यात्	yadi saḥ syāt	sent.
यद्यपि सः दरिद्रः ...	yadyapi saḥ daridraḥ ...	phrase
यद्येवं कुर्यान्न कदापि दुःखस्य कारणं स्यात्	yadyevaṃ kuryānna kadāpi duḥkhasya kāraṇaṃ syāt	sent.
यद्वा तद्वा वृष्टिः	yadvā tadvā vṛṣṭiḥ	sent.
यन्त्राकारे उद्योगः	yantrākāre udyogaḥ	sent.
यात्रापत्रय क्रयण-स्थानं तत्र अस्ति	yātrāpatraya krayaṇa-sthānaṃ tatra asti	sent.
यात्रापत्रं कुत्र क्रेतव्यम् ?	yātrāpatraṃ kutra kretavyam ?	sent.
यानस्य निर्गमनाय इतोऽपि अर्धघण्टा अस्ति	yānasya nirgamanāya ito pi ardhaghaṇṭā asti	sent.
याने तैलं नास्ति	yāne tailaṃ nāsti	sent.
याने महान् सम्मर्दः आसीत्	yāne mahān sammardaḥ āsīt	sent.
याने स्थापय	yāne sthāpaya	sent.
यानं आगतं, आगच्छामि	yānaṃ āgataṃ, āgacchāmi	sent.
यानं तदानीं एव आगत्य स्थितम्	yānaṃ tadānīṃ eva āgatya sthitam	sent.
यानं दशवादने आगच्छति	yānaṃ daśavādane āgacchati	sent.
यानं न प्राप्तं, अत एव विलम्बः	yānaṃ na prāptaṃ, ata eva vilambaḥ	sent.
यानं न लब्धम्	yānaṃ na labdham	sent.
यानं न स्थापय	yānaṃ na sthāpaya	phrase
यावत् आवश्यकं तावत्	yāvat āvaśyakaṃ tāvat	phrase
यावदहं प्रत्यागच्छामि, तावद् प्रतीक्षां करोतु	yāvadahaṃ pratyāgacchāmi, tāvad pratīkṣāṃ karotu	sent.
यावद् रोचते तावदेव स्वीकरोतु	yāvad rocate tāvadeva svīkarotu	sent.
युक्ते समये आगतवान्	yukte samaye āgatavān	sent.
युगादि शुभाशयाः	yugādi śubhāśayāḥ	sent.
यूयं पुस्तकम् अपश्यत	yūyaṃ pustakam apaśyata	sent.
यूयं फलानि अखादत	yūyaṃ phalāni akhādata	sent.
यूयं वदत	yūyaṃ vadata	sent.
योजनिक	yojanika	phrase
यः तत्त्वसाक्षात्कारं प्राप्तवान् स्यात् सः बह्यस्थितिविषये आस्थारहितः भवति इति गुरुः अवदत्	yaḥ tattvasākṣātkāraṃ prāptavān syāt saḥ bahyasthitiviṣaye āsthārahitaḥ bhavati iti guruḥ avadat	sent.
रजकः वस्त्रं नीतवान् वा?	rajakaḥ vastraṃ nītavān vā?	sent.
रमेशः उत्तीर्णः वा?	rameśaḥ uttīrṇaḥ vā?	sent.
रमेशः भवन्तं आह्वयति	rameśaḥ bhavantaṃ āhvayati	sent.
रविर्मेघानामुपरि चरति.	ravirmeghānāmupari carati.	sent.
रविवासरे कः दिनाङ्कः?	ravivāsare kaḥ dināṅkaḥ?	sent.
रविवासरे चतुर्विंशतितमदिनाङ्कः?	ravivāsare caturviṃśatitamadināṅkaḥ?	sent.
रविवासरे तान् आह्वयामः वा?	ravivāsare tān āhvayāmaḥ vā?	sent.
रष्यदेशे पुरातने सर्वे छात्राः गणितं पठितवन्तः	raṣyadeśe purātane sarve chātrāḥ gaṇitaṃ paṭhitavantaḥ	sent.
राजगृहाद् आगच्छति	rājagṛhād āgacchati	sentence
राजभवनस्य द्वारम् उभौ रक्षकभटौ रक्षन्तौ आस्ताम्	rājabhavanasya dvāram ubhau rakṣakabhaṭau rakṣantau āstām	sent.
राजुमहोदयस्य गृहं वा?	rājumahodayasya gṛhaṃ vā?	sent.
रात्रौ कषायं करोमि	rātrau kaṣāyaṃ karomi	sent.
रात्रौ निद्रा एव नास्ति भोः	rātrau nidrā eva nāsti bhoḥ	sent.
रात्रौ निद्रा सम्यक् आसीत्	rātrau nidrā samyak āsīt	sent.
रामः तं ताडयितुं हस्तम् उन्नीतवान्	rāmaḥ taṃ tāḍayituṃ hastam unnītavān	sent.
रामः सीतां अयोध्यायां परिणीतवान्	rāmaḥ sītāṃ ayodhyāyāṃ pariṇītavān	sent.
राष्ट्रीय राजधान्यां देहल्यां गतदिने पञ्चचत्वारिंशत् डिग्रीसेल्सियस् मितं तापमानम् अभिलेखितम्	rāṣṭrīya rājadhānyāṃ dehalyāṃ gatadine pañcacatvāriṃśat ḍigrīselsiyas mitaṃ tāpamānam abhilekhitam	sent.
रिक्तम् स्थलम्	riktam sthalam	phrase
री बालक	rī bālaka	sent.
रुचिकरं नास्ति वा?	rucikaraṃ nāsti vā?	sent.
रुदन् आसीत्	rudan āsīt	sent.
रूप्यकस्य कति फलानि?	rūpyakasya kati phalāni?	sent.
रूप्यकस्य पञ्च	rūpyakasya pañca	sent.
रूप्यकानि शतम्	rūpyakāni śatam	phrase
रोटिका अस्ति चेत् समीचीनं भविष्यति	roṭikā asti cet samīcīnaṃ bhaviṣyati	sent.
रोटिका आसीत् चेत् समीचीनं अभविष्यत्	roṭikā āsīt cet samīcīnaṃ abhaviṣyat	sent.
लज्जाकरम् !	lajjākaram !	sent.
लज्जा मास्तु.	lajjā māstu.	sent.
लतायाम् पुष्पम् विकसति	latāyām puṣpam vikasati	sent.
लभ्यते	labhyate	sent.
लवणं एव नास्ति	lavaṇaṃ eva nāsti	sent.
लवणं किञ्चित् अधिकम्	lavaṇaṃ kiñcit adhikam	sent.
लवणं किञ्चित् योजयतु, सम्यक् भवति	lavaṇaṃ kiñcit yojayatu, samyak bhavati	sent.
लिपिकं दृष्टवान् वा?	lipikaṃ dṛṣṭavān vā?	sent.
लेखनीं एकवारं ददाति वा?	lekhanīṃ ekavāraṃ dadāti vā?	sent.
लोकयानेन	lokayānena	phrase
लोकयानेन गच्छामः	lokayānena gacchāmaḥ	sent.
लोकयानं न प्राप्तम्	lokayānaṃ na prāptam	sent.
लोकयानं प्रस्थितम्	lokayānaṃ prasthitam	sent.
वक्तव्यं आसीत्, करोमि स्म	vaktavyaṃ āsīt, karomi sma	sent.
वक्ता प्रष्टा कोऽपि नास्ति वा?	vaktā praṣṭā ko pi nāsti vā?	sent.
वक्तुं न शक्यते	vaktuṃ na śakyate	sent.
वत्	vat	affix
वत्से , सायङ्काले वृष्टिः भविष्यति । आसन्दान् अन्तः आनीय स्थापयतु कृपया	vatse , sāyaṅkāle vṛṣṭiḥ bhaviṣyati | āsandān antaḥ ānīya sthāpayatu kṛpayā	sent.
वदतु	vadatu	imp.
वदतु, कं पाठं पाठयामि ?	vadatu, kaṃ pāṭhaṃ pāṭhayāmi ?	sent.
वने सिंहः गर्जति	vane siṃhaḥ garjati	sent.
वयम् अक्रीडाम	vayam akrīḍāma	sent.
वयम् अवदाम	vayam avadāma	sent.
वयम् अवसाम	vayam avasāma	sent.
वयम् आम्रम् अखादम	vayam āmram akhādama	sent.
वयम् क्षमामहे	vayam kṣamāmahe	sent.
वयम् गीतम् गायाम	vayam gītam gāyāma	sent.
वयम् पिबामः	vayam pibāmaḥ	sent.
वयम् बहु कालं प्रतीक्षितवन्तः	vayam bahu kālaṃ pratīkṣitavantaḥ	sent.
वयम् शङ्कामहे	vayam śaṅkāmahe	sent.
वयस्य, इमे सर्वे के?	vayasya, ime sarve ke?	sent.
वयस्यः पत्रम् अलिखत्	vayasyaḥ patram alikhat	sent.
वयं आगतवन्तः एव	vayaṃ āgatavantaḥ eva	sent.
वयं आहत्य अष्टजनाः	vayaṃ āhatya aṣṭajanāḥ	sent.
वयं इदानीं अन्यद्गृहे स्मः	vayaṃ idānīṃ anyadgṛhe smaḥ	sent.
वयं यतामहे	vayaṃ yatāmahe	sent.
वयं श्लाघामहे	vayaṃ ślāghāmahe	sent.
वयं सर्वे विस्मृताः वा?	vayaṃ sarve vismṛtāḥ vā?	sent.
वयं सहामहे	vayaṃ sahāmahe	sent.
वरस्य पश्चाद् बन्धवः सीदन्ति.	varasya paścād bandhavaḥ sīdanti.	sent.
वरः विदेशे अस्ति	varaḥ videśe asti	sent.
वर्गशः विभक्ति	vargaśaḥ vibhakti	phrase
वलयस्य विन्यासः आकर्षकः अस्ति	valayasya vinyāsaḥ ākarṣakaḥ asti	sent.
वस्तुतः महनीयम् एतत्	vastutaḥ mahanīyam etat	sent.
वस्तूनि तावन्ति एव वा?	vastūni tāvanti eva vā?	sent.
वस्त्राणि शुष्कयितुं प्रसारयतु	vastrāṇi śuṣkayituṃ prasārayatu	sent.
वातायनसमीपे रिक्तं स्थलम् अस्ति	vātāyanasamīpe riktaṃ sthalam asti	sent.
वानराः कुपिताः अभवन्	vānarāḥ kupitāḥ abhavan	sent.
वामतः चल	vāmataḥ cala	sentence
वायुगुणः कीदृशः ?	vāyuguṇaḥ kīdṛśaḥ ?	sent.
वायुरहो वायुः	vāyuraho vāyuḥ	sent.
वायुः एव नास्ति	vāyuḥ eva nāsti	sent.
वार्ता समाप्ता वा?	vārtā samāptā vā?	sent.
वाहनम् प्रविशतु !	vāhanam praviśatu !	sent.
विकसतु	vikasatu	imperative
विजयलाभे अभिनन्दनम्	vijayalābhe abhinandanam	sent.
विज्ञापन संस्थायाम्	vijñāpana saṃsthāyām	phrase
विज्ञायते	vijñāyate	expr.
वित्तकोषः कियद्दूरे अस्ति?	vittakoṣaḥ kiyaddūre asti?	sent.
विदेशं गमिष्यति	videśaṃ gamiṣyati	sent.
विद्यालयं प्राप्नोमि	vidyālayaṃ prāpnomi	sentence
विना कारणं किमर्थं गन्तव्यम्?	vinā kāraṇaṃ kimarthaṃ gantavyam?	sent.
विना कारणं कुप्यति	vinā kāraṇaṃ kupyati	sent.
विना शब्दं भोजनं कुर्वन्तु नाम	vinā śabdaṃ bhojanaṃ kurvantu nāma	sent.
विनाशं व्रजति	vināśaṃ vrajati	sent.
विपणीं गच्छ	vipaṇīṃ gaccha	sent.
विपणेः पश्चात्	vipaṇeḥ paścāt	phrase
विरोधवेदन बिना	virodhavedana binā	phrase
विविधभारतीं योजयतु	vividhabhāratīṃ yojayatu	sent.
विविधविषयान्	vividhaviṣayān	phrase
विशेषतया कोऽपि न व्रणितः?	viśeṣatayā ko pi na vraṇitaḥ?	sent.
विषयस्य वर्धनं मास्तु	viṣayasya vardhanaṃ māstu	sent.
विहारभूमि	vihārabhūmi	phrase
विंशतिरूप्यकाणि वा? तर्हि मास्तु	viṃśatirūpyakāṇi vā? tarhi māstu	sent.
वीराणां भयं नास्ति.	vīrāṇāṃ bhayaṃ nāsti.	sent.
वृक्षस्य उपरि	vṛkṣasya upari	phrase
वृक्षस्य दक्षिणे भागे	vṛkṣasya dakṣiṇe bhāge	phrase
वृक्षं परि सिञ्चति	vṛkṣaṃ pari siñcati	sent.
वृक्षः उन्नतः अस्ति	vṛkṣaḥ unnataḥ asti	sent.
वृक्षः कम्पते	vṛkṣaḥ kampate	sent.
वृत्तस्य परिधेः मध्ये केन्द्रबिन्दुः भवति	vṛttasya paridheḥ madhye kendrabinduḥ bhavati	sent.
वृथा कालहरणं करोति	vṛthā kālaharaṇaṃ karoti	sent.
वृथा भवान् चिन्तां करोति	vṛthā bhavān cintāṃ karoti	sent.
वृद्धः आम्रवृक्षस्य समीपम् अगच्छत्	vṛddhaḥ āmravṛkṣasya samīpam agacchat	sent.
वृन्ताकं मा पचतु इति पूर्वमेव उक्तवान् किल ?	vṛntākaṃ mā pacatu iti pūrvameva uktavān kila ?	sent.
वृष्टितः एव भयम्	vṛṣṭitaḥ eva bhayam	sent.
वृष्टिः भवति । कृपया मितवेगेन वाहनं चालयतु, वस्ते ।	vṛṣṭiḥ bhavati | kṛpayā mitavegena vāhanaṃ cālayatu, vaste |	sent.
वेतनं लब्धं वा?	vetanaṃ labdhaṃ vā?	sent.
वेलापत्रिका आगता वा?	velāpatrikā āgatā vā?	sent.
वेलां कथय	velāṃ kathaya	sent.
वैद्यस्य निर्देशनं स्वीकरोतु	vaidyasya nirdeśanaṃ svīkarotu	sent.
वैद्या भविष्यति	vaidyā bhaviṣyati	sent.
वैद्यं कदा दृष्टवान्?	vaidyaṃ kadā dṛṣṭavān?	sent.
वैद्यं पश्यतु	vaidyaṃ paśyatu	sent.
व्यकसत्	vyakasat	imperfect
व्यजनं चालयतु	vyajanaṃ cālayatu	sent.
व्यञ्जने लवणं न्यूनम्	vyañjane lavaṇaṃ nyūnam	sent.
व्यत्यासेन	vyatyāsena	instr.
व्याघरणं कृतं चेत् पाकः सिद्धः	vyāgharaṇaṃ kṛtaṃ cet pākaḥ siddhaḥ	sent.
व्याघ्रः मांसम् अखादत्	vyāghraḥ māṃsam akhādat	sent.
व्याघ्रः वनम् अधितिष्टति	vyāghraḥ vanam adhitiṣṭati	sent.
व्यावर्तकम्+नोदनम्	vyāvartakam+nodanam	phrase
शङ्के	śaṅke	phrase
शत भाग	śata bhāga	phrase
शतं जीव शरदो वर्धमानाः	śataṃ jīva śarado vardhamānāḥ	sent.
शय्यायाः उपरि नासीत् । मम कोषे एव आसीत् । क्षम्यताम्	śayyāyāḥ upari nāsīt | mama koṣe eva āsīt | kṣamyatām	sent.
शरणं व्रजति	śaraṇaṃ vrajati	sent.
शशविषानम्	śaśaviṣānam	fig.
शाकम् आनय	śākam ānaya	sent.
शाकं किञ्चित् कर्तयित्वा ददातु	śākaṃ kiñcit kartayitvā dadātu	sent.
शाकः नास्ति, अहं किं करोमि?	śākaḥ nāsti, ahaṃ kiṃ karomi?	sent.
शाटिकया सा प्रौढा इव दृश्यते	śāṭikayā sā prauḍhā iva dṛśyate	sent.
शाद्वले उपविशामि	śādvale upaviśāmi	sent.
शाला दशवादनतः किल?	śālā daśavādanataḥ kila?	sent.
शालायां बीजगणितम् अहं सम्यक् न गृहीतवती	śālāyāṃ bījagaṇitam ahaṃ samyak na gṛhītavatī	sent.
शिरसि तैलसमुक्षणं करोतु	śirasi tailasamukṣaṇaṃ karotu	sent.
शिरो रक्ष	śiro rakṣa	sent.
शिशुः क्षीरम् अपिबत्	śiśuḥ kṣīram apibat	sent.
शिशुः रोदिति	śiśuḥ roditi	sent.
शीघ्र अभिसारी श्रेढि	śīghra abhisārī śreḍhi	phrase
शीघ्रम् , अम्बा अस्मान् आह्वयति	śīghram , ambā asmān āhvayati	sent.
शीघ्रम् अवतरतु	śīghram avataratu	sent.
शीघ्रम् आगच्छ	śīghram āgaccha	sent.
शीघ्रम् आगच्छतु	śīghram āgacchatu	sent.
शीघ्रम् आगन्तव्यम्	śīghram āgantavyam	sent.
शीघ्रं अवतरतु	śīghraṃ avataratu	sent.
शीघ्रं आगच्छतु, यानं गच्छति	śīghraṃ āgacchatu, yānaṃ gacchati	sent.
शीघ्रं पठित्वा ददामि भोः	śīghraṃ paṭhitvā dadāmi bhoḥ	sent.
शीघ्रं प्रत्यागच्छामि	śīghraṃ pratyāgacchāmi	sent.
शीघ्रं भोजनं करोतु, विलम्बः अभवत्	śīghraṃ bhojanaṃ karotu, vilambaḥ abhavat	sent.
शीघ्रं सज्जो	śīghraṃ sajjo	sent.
शीघ्रं स्नानं कृत्वा आगच्छतु	śīghraṃ snānaṃ kṛtvā āgacchatu	sent.
शुद्धं नवनीतं ददातु	śuddhaṃ navanītaṃ dadātu	sent.
शुनकः किमर्थम् इत्थं भषति ? देहल्यां कः इति पश्यतु, वस्त	śunakaḥ kimartham itthaṃ bhaṣati ? dehalyāṃ kaḥ iti paśyatu, vasta	sent.
शुनकः जलं पिबन् आसीत्	śunakaḥ jalaṃ piban āsīt	sent.
शुभरात्रिः	śubharātriḥ	expr.
शुभाः ते पन्थानः	śubhāḥ te panthānaḥ	sent.
शुभं जन्मदिनम्	śubhaṃ janmadinam	sent.
शुभं नववर्षम्	śubhaṃ navavarṣam	sent.
शृणु !	śṛṇu !	phrase
शेषे रत्रौ	śeṣe ratrau	loc.
शैत्यं अहो शैत्यं!	śaityaṃ aho śaityaṃ!	sent.
शोधिने चायकषाये किञ्चित् क्षीरं कृपया योजयतु	śodhine cāyakaṣāye kiñcit kṣīraṃ kṛpayā yojayatu	sent.
शौचालयं गच्छामि	śaucālayaṃ gacchāmi	sentence
श्रद्धया करणीयम्	śraddhayā karaṇīyam	sent.
श्रद्धया शृणोतु तावत्	śraddhayā śṛṇotu tāvat	sent.
श्रीमन्	śrīman	expr.
श्रीमन्, अन्तः आगच्छामि वा?	śrīman, antaḥ āgacchāmi vā?	sent.
श्रीमन्, विशेषकक्ष्यां स्वीकरोति वा?	śrīman, viśeṣakakṣyāṃ svīkaroti vā?	sent.
श्रूयताम्	śrūyatām	sent.
श्वस्तन-दर्शनाय	śvastana-darśanāya	sent.
श्वस्ति , मङ्गलं भूयात्	śvasti , maṅgalaṃ bhūyāt	sent.
श्वः अहम् एव रेल्स्थानके तां त्यक्ष्यामि	śvaḥ aham eva relsthānake tāṃ tyakṣyāmi	sent.
श्वः अहं मम वैद्यं द्र्क्ष्यामि	śvaḥ ahaṃ mama vaidyaṃ drkṣyāmi	sent.
श्वः आगन्तुं शक्नोति	śvaḥ āgantuṃ śaknoti	sent.
श्वः आरभ्य सहाध्ययनं कुर्मः	śvaḥ ārabhya sahādhyayanaṃ kurmaḥ	sent.
श्वः एतद् सम्यक् पठित्वा आगन्तव्यम्	śvaḥ etad samyak paṭhitvā āgantavyam	sent.
श्वः किम् दिनम् इति जानासि ?	śvaḥ kim dinam iti jānāsi ?	sent.
श्वः तस्य आगमनार्थम् अहम् अस्माकं गृहं दर्शितवान्	śvaḥ tasya āgamanārtham aham asmākaṃ gṛhaṃ darśitavān	sent.
श्वः प्रातः अहं भवतः गृहं कार्यानं प्रेषयिष्यामि	śvaḥ prātaḥ ahaṃ bhavataḥ gṛhaṃ kāryānaṃ preṣayiṣyāmi	sent.
श्वः प्रातःकाले प्रथमम् एतं विषयं तं निवेदयिष्यामि	śvaḥ prātaḥkāle prathamam etaṃ viṣayaṃ taṃ nivedayiṣyāmi	sent.
श्वः मम परीक्षा अस्ति	śvaḥ mama parīkṣā asti	sent.
श्वः शालायां सः तस्य सखीं द्र्क्ष्यति	śvaḥ śālāyāṃ saḥ tasya sakhīṃ drkṣyati	sent.
श्वः सायं मिलामः वा?	śvaḥ sāyaṃ milāmaḥ vā?	sent.
श्वः सोमवारः	śvaḥ somavāraḥ	sent.
श्वः हिमपातः भविष्यति इति दूरदर्शने अहं दृष्टवान् । अतः श्वः मन्दिरं निश्चयेन गमिष्यामि इति इदानीं वक्तुं न शक्यते	śvaḥ himapātaḥ bhaviṣyati iti dūradarśane ahaṃ dṛṣṭavān | ataḥ śvaḥ mandiraṃ niścayena gamiṣyāmi iti idānīṃ vaktuṃ na śakyate	sent.
षट् वातायनानि सन्ति.	ṣaṭ vātāyanāni santi.	sent.
षड्भ्यः दिनेभ्यः परम्	ṣaḍbhyaḥ dinebhyaḥ param	phrase
षड्भ्यः दिनेभ्यः पूर्वम्	ṣaḍbhyaḥ dinebhyaḥ pūrvam	phrase
षड्वादनपर्यन्तं तत्र किं करोति?	ṣaḍvādanaparyantaṃ tatra kiṃ karoti?	sent.
षड्वादनात् परम्	ṣaḍvādanāt param	phrase
षड्वादनात् पूर्वं न	ṣaḍvādanāt pūrvaṃ na	phrase
षत् फलानि सन्ति.	ṣat phalāni santi.	sent.
षष्टिसङ्ख्याकं यानं गतं वा?	ṣaṣṭisaṅkhyākaṃ yānaṃ gataṃ vā?	sent.
षष्ठी विभक्ति	ṣaṣṭhī vibhakti	phrase
स कुत्र गच्छति ?	sa kutra gacchati ?	sent.
सङ्कल्पयति	saṅkalpayati	sent.
सङ्कोचः मास्तु, आवश्यकं चेत् पृच्छतु	saṅkocaḥ māstu, āvaśyakaṃ cet pṛcchatu	sent.
सङ्गृहीत: उपविधि	saṅgṛhīta: upavidhi	phrase
सज्जा भव	sajjā bhava	sent.
स तस्य समीपम् आगतवान्	sa tasya samīpam āgatavān	sent.
सत्यम् एव	satyam eva	sent.
सत्यम् भोः !	satyam bhoḥ !	sent.
सत्यम्, सत्यम्	satyam, satyam	expr.
सत्यं सत्यं न संशयः	satyaṃ satyaṃ na saṃśayaḥ	sent.
सदैव काले	sadaiva kāle	expr.
सन्तोषेन गच्छति	santoṣena gacchati	sentence
सपादचतुर्वादनम्	sapādacaturvādanam	sent.
सप्तमी विभक्ति	saptamī vibhakti	phrase
सफलतायै अभिनन्दनम्	saphalatāyai abhinandanam	sent.
स मया सह वसति	sa mayā saha vasati	sent.
समये आगच्छ	samaye āgaccha	sent.
समये आगच्छतु	samaye āgacchatu	sent.
समये एकमपि न मिलति	samaye ekamapi na milati	sent.
समये किमपि न मिलति	samaye kimapi na milati	sent.
समयः कथं अतिशीघ्रं अतीतः!	samayaḥ kathaṃ atiśīghraṃ atītaḥ!	sent.
समयः स्नानभोजनं सेवितुम्	samayaḥ snānabhojanaṃ sevitum	sent.
समाप्तप्रायम्	samāptaprāyam	sent.
समाप्तं वा?	samāptaṃ vā?	expr.
समितिः अनुमतिम् अयच्छत्	samitiḥ anumatim ayacchat	sent.
समीचीना सूचना	samīcīnā sūcanā	expr.
समीपे एकः आम्रवृक्षः आसीत्	samīpe ekaḥ āmravṛkṣaḥ āsīt	sent.
सम्पूर्णम् दिनम्	sampūrṇam dinam	phrase
सम्बोधन विभक्ति	sambodhana vibhakti	phrase
सम्भृत: उपविधि	sambhṛta: upavidhi	phrase
सम्मार्जनं कृतवती वा?	sammārjanaṃ kṛtavatī vā?	sent.
सम्यक् उपविश	samyak upaviśa	sent.
सम्यक् दन्तधावनं करोतु	samyak dantadhāvanaṃ karotu	sent.
सम्यक् न स्मरामि भोः	samyak na smarāmi bhoḥ	sent.
सर्पाः मण्डूकान् अगिलन्	sarpāḥ maṇḍūkān agilan	sent.
सर्वत्र अग्रे सरति	sarvatra agre sarati	sent.
सर्वथा मास्तु	sarvathā māstu	expr.
सर्वदा सङ्गणकस्य पुरतः उपविश्य किम् करोति ? अङ्गणं गत्वा जलेन पुष्पसस्यानि सिञ्चतु	sarvadā saṅgaṇakasya purataḥ upaviśya kim karoti ? aṅgaṇaṃ gatvā jalena puṣpasasyāni siñcatu	sent.
सर्वदा सत्यं वदेः.	sarvadā satyaṃ vadeḥ.	sent.
सर्वयाने	sarvayāne	loc.
सर्वस्य अपि भवान् एव मूलम्	sarvasya api bhavān eva mūlam	sent.
सर्वस्य अपि मितिः भवेत्	sarvasya api mitiḥ bhavet	sent.
सर्वासां समस्यानां मूलम् एतत् एव	sarvāsāṃ samasyānāṃ mūlam etat eva	sent.
सर्वेभ्यो नमः.	sarvebhyo namaḥ.	sent.
सर्वे मिलित्वा गतवन्तः वा?	sarve militvā gatavantaḥ vā?	sent.
सर्वे मिलित्वा भोजनं कुर्मः	sarve militvā bhojanaṃ kurmaḥ	sent.
सर्वे वृक्षस्य अधः उपविष्टवन्तः	sarve vṛkṣasya adhaḥ upaviṣṭavantaḥ	sent.
सर्वेषां स्वागतम्	sarveṣāṃ svāgatam	sent.
सर्वैः कथ्यते	sarvaiḥ kathyate	sent.
सर्वं कुशलम्	sarvaṃ kuśalam	sent.
सर्वं तत्रैव अस्ति, किञ्चित् पश्यन्तु	sarvaṃ tatraiva asti, kiñcit paśyantu	sent.
सर्वं भवता करणीयम् इति न । अहं तत्र आगत्य साहाय्यं करवानि । कृपया प्रतीक्षां करोतु ।	sarvaṃ bhavatā karaṇīyam iti na | ahaṃ tatra āgatya sāhāyyaṃ karavāni | kṛpayā pratīkṣāṃ karotu |	sent.
सर्वं भवान् एव खादितवान् वा?	sarvaṃ bhavān eva khāditavān vā?	sent.
सर्वं सम्यक् भविष्यति	sarvaṃ samyak bhaviṣyati	sent.
सहस्रवारं उक्तं, श्रुतवान् वा?	sahasravāraṃ uktaṃ, śrutavān vā?	sent.
सह् फलानि सन्तोषेण अखादत्	sah phalāni santoṣeṇa akhādat	sent.
सा अङ्गुलीयकं कोपेन विक्षिप्तवति	sā aṅgulīyakaṃ kopena vikṣiptavati	sent.
साकल्येन	sākalyena	instr.
सा का ?	sā kā ?	sent.
सा गीतम् अगायत्	sā gītam agāyat	sent.
सा गृहे वसति	sā gṛhe vasati	sent.
सा देवालये कार्यकर्त्री । तस्मातेव तया किञ्चित् शीग्रं गन्तव्यम् अस्ति ।	sā devālaye kāryakartrī | tasmāteva tayā kiñcit śīgraṃ gantavyam asti |	sent.
साधु	sādhu	phrase
सापेक्षमिदम्	sāpekṣamidam	sent.
सामान्यतः शिरोवेदना तदा तदा आगच्छति	sāmānyataḥ śirovedanā tadā tadā āgacchati	sent.
सामिसुखयानेन	sāmisukhayānena	sent.
सायङ्काले उर्सुला समीचीनं चोलं धृतवती	sāyaṅkāle ursulā samīcīnaṃ colaṃ dhṛtavatī	sent.
सायङ्काले गृहे सीता पत्या साकं भोजनं करोति	sāyaṅkāle gṛhe sītā patyā sākaṃ bhojanaṃ karoti	sent.
सा यदा दूरवाण्या तस्य स्वरं श्रुतवती तदा एव तस्याः सर्वाणि कष्टानि विस्मृतवती	sā yadā dūravāṇyā tasya svaraṃ śrutavatī tadā eva tasyāḥ sarvāṇi kaṣṭāni vismṛtavatī	sent.
सायं आगमनसमये शाकं आनयन्ति वा?	sāyaṃ āgamanasamaye śākaṃ ānayanti vā?	sent.
सार्धपञ्चवादने अहं गृहे तिष्ठामि	sārdhapañcavādane ahaṃ gṛhe tiṣṭhāmi	sent.
सार्धं द्विघण्टात्मकः कार्यक्रमः	sārdhaṃ dvighaṇṭātmakaḥ kāryakramaḥ	sent.
सावधानं परिवेषयतु	sāvadhānaṃ pariveṣayatu	sent.
सिद्धता कथम् अस्ति?	siddhatā katham asti?	sent.
सिंहः आगच्छन् अस्ति	siṃhaḥ āgacchan asti	sent.
सिंहः मृगम् अमारयत्	siṃhaḥ mṛgam amārayat	sent.
सीता दुःखेन कृशी भूता ।	sītā duḥkhena kṛśī bhūtā |	sent.
सीता रावणं न गणयति स्म	sītā rāvaṇaṃ na gaṇayati sma	sent.
सुखयानेन	sukhayānena	phrase
सुखी भव	sukhī bhava	sent.
सुखं व्रजति	sukhaṃ vrajati	sent.
सुगम	sugama	sent.
सुतलाभेन कृती बभूव	sutalābhena kṛtī babhūva	sent.
सुदिनम् आर्य	sudinam ārya	sent.
सुन्दराणि वस्त्राणि	sundarāṇi vastrāṇi	phrase
सुन्दरं दृश्यसे	sundaraṃ dṛśyase	sent.
सुपिष्टम्	supiṣṭam	sent.
सुप्रभातम्	suprabhātam	expr.
सुभम् अस्तु	subham astu	sent.
सुलभेन तस्य जाले पतितवान्	sulabhena tasya jāle patitavān	sent.
सूदन	sūdana	sent.
सेवकं किञ्चित् आह्वयतु	sevakaṃ kiñcit āhvayatu	sent.
सोदरैः सह	sodaraiḥ saha	phrase
सोपाने सावधानम्	sopāne sāvadhānam	phrase
सौचिकः कर्तर्या वस्त्रं कर्तयति	saucikaḥ kartaryā vastraṃ kartayati	sent.
संलपन्तः	saṃlapantaḥ	sent.
संवादः / कथा समीचीना अस्ति	saṃvādaḥ / kathā samīcīnā asti	sent.
संशयः अस्ति चेत् पृच्छन्तु!	saṃśayaḥ asti cet pṛcchantu!	sent.
संसक्त	saṃsakta	sent.
संस्कृतम् अतीव सरलभाषा	saṃskṛtam atīva saralabhāṣā	sent.
संस्कृतवार्ताप्रसारः सायं दशाधिक षड्वादने	saṃskṛtavārtāprasāraḥ sāyaṃ daśādhika ṣaḍvādane	sent.
संस्कृतात् ऋते गीतायाः मूलार्थः न ज्ञायते	saṃskṛtāt ṛte gītāyāḥ mūlārthaḥ na jñāyate	sent.
संस्कृतं पठामि	saṃskṛtaṃ paṭhāmi	sentence
सः अक्रीद्डत्	saḥ akrīdḍat	sent.
सः अत्र नास्ति	saḥ atra nāsti	sent.
सः अमोदत	saḥ amodata	sent.
सः अस्वस्थः । अतः अद्य सः पादकन्दुकस्पर्धायां न क्रीडिष्यति	saḥ asvasthaḥ | ataḥ adya saḥ pādakandukaspardhāyāṃ na krīḍiṣyati	sent.
सः आगतवान् इति स्मरामि	saḥ āgatavān iti smarāmi	sent.
सः आगतवान्, एषः प्रस्थितवान्	saḥ āgatavān, eṣaḥ prasthitavān	sent.
सः इदानीमपि बालः	saḥ idānīmapi bālaḥ	sent.
सः इदानीं अपि न आगतवान् वा?	saḥ idānīṃ api na āgatavān vā?	sent.
सः एकम् उपायम् अकरोत्	saḥ ekam upāyam akarot	sent.
सः एकसप्ताहाभ्यन्तरे आगच्छेत्	saḥ ekasaptāhābhyantare āgacchet	sent.
सः कथापुस्तकं ग्रन्थालयं प्रत्यार्पितवान्	saḥ kathāpustakaṃ granthālayaṃ pratyārpitavān	sent.
सः कदा बहिः गतवान् इति अहं न जाने	saḥ kadā bahiḥ gatavān iti ahaṃ na jāne	sent.
सः कार्यालये तिष्ठति	saḥ kāryālaye tiṣṭhati	sent.
सः किमपि उक्तवान् वा?	saḥ kimapi uktavān vā?	sent.
सः कुञ्चिकया तालम् उद्घाटयति	saḥ kuñcikayā tālam udghāṭayati	sent.
सः कुत्रत्यः ?	saḥ kutratyaḥ ?	sent.
सः क्षुधित अभवत्	saḥ kṣudhita abhavat	sent.
सः गतवान् किम् ?	saḥ gatavān kim ?	sent.
सः चिकित्सालये प्रवेशितः	saḥ cikitsālaye praveśitaḥ	sent.
सः तव शिक्षकः किं?	saḥ tava śikṣakaḥ kiṃ?	sent.
सः तस्याः निवेदनं न पुरस्कृतवान्	saḥ tasyāḥ nivedanaṃ na puraskṛtavān	sent.
सः धनम् ऊरुकस्य स्यूते स्थापितवान्	saḥ dhanam ūrukasya syūte sthāpitavān	sent.
सः निष्ठावान्	saḥ niṣṭhāvān	sent.
सः बहु रूक्शः	saḥ bahu  rūkśaḥ	sent.
सः बहु समीचीनः	saḥ bahu samīcīnaḥ	sent.
सः बालकौ वाहने उपावेशयत्	saḥ bālakau vāhane upāveśayat	sent.
सः बालकः कः?	saḥ bālakaḥ kaḥ?	sent.
सः बालः तस्य सोदरात् बलवत्तरः.	saḥ bālaḥ tasya sodarāt balavattaraḥ.	sent.
सः भाषते	saḥ bhāṣate	sent.
सः मत् बलवत्तरः	saḥ mat balavattaraḥ	sent.
सः मम छात्रः.	saḥ mama chātraḥ.	sent.
सः मम दोषः न	saḥ mama doṣaḥ na	sent.
सः मम सहपाठी आसीत्	saḥ mama sahapāṭhī āsīt	sent.
सः यानपेटिकाम् सावधानम् उद्घाटितवान्	saḥ yānapeṭikām sāvadhānam udghāṭitavān	sent.
सः वर्षद्वयात् पूर्वमेव निवृत्तः	saḥ varṣadvayāt pūrvameva nivṛttaḥ	sent.
सः वहतु	saḥ vahatu	sent.
सः विद्यालये पठति	saḥ vidyālaye paṭhati	sentence
सः विरामं स्वीकृतवान्	saḥ virāmaṃ svīkṛtavān	sent.
सः विश्वासयोग्यो वा?	saḥ viśvāsayogyo vā?	sent.
सः विश्वासयोग्यः किम्?	saḥ viśvāsayogyaḥ kim?	sent.
सः वृद्धः इव भाति	saḥ vṛddhaḥ iva bhāti	sent.
सः वृद्धः जातः	saḥ vṛddhaḥ jātaḥ	sent.
सः शालां याति	saḥ śālāṃ yāti	sent.
सः शीघ्रकोपी	saḥ śīghrakopī	sent.
सः शोणवक्शस्खगः उत्पतति.	saḥ śoṇavakśaskhagaḥ utpatati.	sent.
सः श्वः आगच्छेत्	saḥ śvaḥ āgacchet	sent.
सः सङ्गणकं अन्तर्गच्छति	saḥ saṅgaṇakaṃ antargacchati	sent.
सः सङ्गणकं बहिर्गच्छति	saḥ saṅgaṇakaṃ bahirgacchati	sent.
सः सपादषड्वादनतः सार्धसप्तवादनपर्यन्तं गृहपाठं लिखति	saḥ sapādaṣaḍvādanataḥ sārdhasaptavādanaparyantaṃ gṛhapāṭhaṃ likhati	sent.
सः सर्वत्र दर्वीं चालयति	saḥ sarvatra darvīṃ cālayati	sent.
सः सर्वथा अप्रयोजकः	saḥ sarvathā aprayojakaḥ	sent.
सः सुखी पुरुषः	saḥ sukhī puruṣaḥ	sent.
सः सुखी वा दुःखी वा ?	saḥ sukhī vā duḥkhī vā ?	sent.
सः स्तोकात् मुक्तः	saḥ stokāt muktaḥ	sent.
सः स्वकीयं शिरस्त्रं भूमौ क्षिप्तवान्	saḥ svakīyaṃ śirastraṃ bhūmau kṣiptavān	sent.
सः स्वपत्न्याः वचनं सर्वदा आङ्गीकृतवान्	saḥ svapatnyāḥ vacanaṃ sarvadā āṅgīkṛtavān	sent.
स्थलम् एव नास्ति	sthalam eva nāsti	sent.
स्थातुं मम समयः नास्ति	sthātuṃ mama samayaḥ nāsti	sent.
स्थातुं समयः नास्ति	sthātuṃ samayaḥ nāsti	sent.
स्थापयामि वा?	sthāpayāmi vā?	sent.
स्थालिका एव न स्थापिता!	sthālikā eva na sthāpitā!	sent.
स्थालिका स्थापिता वा?	sthālikā sthāpitā vā?	sent.
स्पष्टतः तथा सुतथ्यतः व्यक्त	spaṣṭataḥ tathā sutathyataḥ vyakta	phrase
स्पष्टं न जानामि	spaṣṭaṃ na jānāmi	sent.
स्मरति किल?	smarati kila?	expr.
स्मारणार्थम्	smāraṇārtham	phrase
स्यात् अस्ति	syāt asti	sent.
स्यात् अस्ति च नास्ति च	syāt asti ca nāsti ca	sent.
स्व इवाचरति	sva ivācarati	sent.
स्वकार्यं कुरु	svakāryaṃ kuru	expr.
स्वकुटुम्बैः सह	svakuṭumbaiḥ saha	phrase
स्वनाम कथय	svanāma kathaya	sent.
स्वयमेव करोति किम् ?	svayameva karoti kim ?	sent.
स्वयमेव करोति वा?	svayameva karoti vā?	sent.
स्वस्य सर्वाणि वस्त्राणि यानपेटिकायां सा सङ्गृहीतवती	svasya sarvāṇi vastrāṇi yānapeṭikāyāṃ sā saṅgṛhītavatī	sent.
स्वागतम्	svāgatam	expr.
स्वामी सर्वत्र अस्ति चेत् किमर्थं सर्वे देवालयं गत्वा तं प्रार्थयन्ति इति बालकः मातरं पृष्टवान्	svāmī sarvatra asti cet kimarthaṃ sarve devālayaṃ gatvā taṃ prārthayanti iti bālakaḥ mātaraṃ pṛṣṭavān	sent.
हठं मा करोतु	haṭhaṃ mā karotu	sent.
हरिः ओम्!	hariḥ om!	expr.
हरिः ओम्	hariḥ om	sent.
हस्तं प्रक्षाल्य उपविशतु	hastaṃ prakṣālya upaviśatu	sent.
हा हन्त! कीदृशम् अकार्यम् आचरितं मया !	hā hanta! kīdṛśam akāryam ācaritaṃ mayā !	sent.
हे नप्तारौ मित्राणाम् अग्रे अपि विवदेथे.	he naptārau mitrāṇām agre api vivadethe.	sent.
हे भगवन् !	he bhagavan !	sent.
ह्यस्तनं व्यञ्जनं कियत् रुचिकरं आसीत्!	hyastanaṃ vyañjanaṃ kiyat rucikaraṃ āsīt!	sent.
ह्यः अहं गृहे आसम्	hyaḥ ahaṃ gṛhe āsam	sent.
ह्यः इडली अलभ्यत	hyaḥ iḍalī alabhyata	sent.
ह्यः एव गिरीशः स्वीकृतवान्	hyaḥ eva girīśaḥ svīkṛtavān	sent.
ह्यः कियत् पर्यन्तं पाठितवान्?	hyaḥ kiyat paryantaṃ pāṭhitavān?	sent.
ह्यः तु स्वस्थः आसीत्	hyaḥ tu svasthaḥ āsīt	sent.
ह्यः त्वम् अपठः ?	hyaḥ tvam apaṭhaḥ ?	sentence
ह्यः त्वं कुत्र आसीः ?	hyaḥ tvaṃ kutra āsīḥ ?	sent.
ह्यः दिवा दशवादनात् पूर्वं न	hyaḥ divā daśavādanāt pūrvaṃ na	phrase
ह्यः फलितांशः प्रकटितः	hyaḥ phalitāṃśaḥ prakaṭitaḥ	sent.
ह्यः बालिकाः सन्देशम् पठितवत्यः	hyaḥ bālikāḥ sandeśam paṭhitavatyaḥ	sent.
ह्यः भवतीं स्मृतवान्	hyaḥ bhavatīṃ smṛtavān	sent.
ह्यः भवन्तं स्मृतवान्	hyaḥ bhavantaṃ smṛtavān	sent.
ह्यः रजकापणतः भवान् मम वस्त्राणि आनीतवान् वा ?	hyaḥ rajakāpaṇataḥ bhavān mama vastrāṇi ānītavān vā ?	sent.
ह्यः रात्रौ नववादनात् परं न	hyaḥ rātrau navavādanāt paraṃ na	phrase
ह्यः रात्रौ सार्ध-सप्तवादनात् पादोन-नववादबपर्यन्तम्	hyaḥ rātrau sārdha-saptavādanāt pādona-navavādabaparyantam	phrase
ह्यः सा भोजनपेटिकां शालां न नीतवती	hyaḥ sā bhojanapeṭikāṃ śālāṃ na nītavatī	sent.
ह्यः सायम्	hyaḥ sāyam	phrase
ह्यः स्पर्धायां के जयं प्राप्तवन्तः ?	hyaḥ spardhāyāṃ ke jayaṃ prāptavantaḥ ?	sent.
