अदस् adas pron.
अधर	adhara pron.
अन्तर	antara pron.
अन्ये	anya	pron.
अन्योन्य	anyonya	pron.
अहम्	aham	pron.
इतर	itara	pron.
इदम्	idam pron.
उत्तर	uttara pron.
एक	eka pron.
कतम	katama pron.
किम्	kim	pron.	
तत्	tad	pron.
त्वम्	tvam	pron.
परस्पर	paraspara	pron.
पर	para	pron.
पूर्व	pūrva pron.
विश्व	viśva pron.
यत्	yad	pron.
स	sa	pron.
सर्व	sarva	pron.
स्व	sva pron.



