अकति	akati	verb
अक्षति	akṣati	verb
अक्षिष्यति	akṣiṣyati	verb
अक्ष्णोति	akṣṇoti	verb
अगति	agati	verb
अगद्यति	agadyati	verb
अगृह्णात्	agṛhṇāt	verb
अग्निसात्करोति	agnisātkaroti	verb
अग्रणी करोति	agraṇī karoti	verb
अग्रतः करोति	agrataḥ karoti	verb
अघायति	aghāyati	verb
अङ्कते	aṅkate	verb
अङ्कयति	aṅkayati	verb
अङ्कयिष्यति	aṅkayiṣyati	future
अङ्कीकरोति	aṅkīkaroti	verb
अङ्कुरयति	aṅkurayati	verb
अङ्खयति	aṅkhayati	verb
अङ्ख्यति	aṅkhyati	verb
अङ्गति	aṅgati	verb
अङ्गारसात् करोति	aṅgārasāt karoti	verb
अङ्गीकरोति	aṅgīkaroti	verb
अङ्घते	aṅghate	verb
अचति	acati	verb
अचालयत्	acālayat	verb
अच्छागम्	acchāgam	verb
अच्छाचरति	acchācarati	verb
अजति	ajati	verb
अजिरायते	ajirāyate	verb
अञ्चति	añcati	verb
अञ्चयति	añcayati	verb
अटतु	aṭatu	verb
अटिष्यति	aṭiṣyati	verb
अट्टते	aṭṭate	verb
अट्टायते	aṭṭāyate	verb
अठति / ते	aṭhati / te	verb
अड्डति	aḍḍati	verb
अणति	aṇati	verb
अणूभू	aṇūbhū	verb
अण्ठते	aṇṭhate	verb
अण्यते	aṇyate	verb
अतिकुप्यति	atikupyati	verb
अतिकूर्दति	atikūrdati	verb
अतिकृष्	atikṛṣ	verb
अतिक्रामति	atikrāmati	verb1
अतिक्रामति	atikrāmati	verb
अतिक्षरति	atikṣarati	verb
अतिख्याति	atikhyāti	verb
अतिगमति	atigamati	verb
अतिगरीयः क्रीणाति	atigarīyaḥ krīṇāti	verb
अतिगर्जति	atigarjati	verb
अतिगुरते	atigurate	verb
अतिगृह्णाति	atigṛhṇāti	verb
अतिचरति	aticarati	verb
अतिचिरयति	aticirayati	verb
अतिचृतति	aticṛtati	verb
अतिचेष्टति	aticeṣṭati	verb
अतिजयति	atijayati	verb
अतितरति	atitarati	verb
अतितिष्ठति	atitiṣṭhati	verb
अतितृणत्ति	atitṛṇatti	verb
अतितृप्यति	atitṛpyati	verb
अतिदघ्यति	atidaghyati	verb
अतिदधाति	atidadhāti	verb
अतिदहति	atidahati	verb
अतिदीव्यति	atidīvyati	verb
अतिदृप्यति	atidṛpyati	verb
अतिद्रवति	atidravati	verb
अतिध्यै	atidhyai	verb
अतिपतति	atipatati	verb
अतिपदति	atipadati	verb
अतिपिपर्ति	atipiparti	verb
अतिपूर्यति	atipūryati	verb
अतिप्रज्वलति	atiprajvalati	verb
अतिप्रवते	atipravate	verb
अतिप्रवयति	atipravayati	verb
अतिप्रशंसति	atipraśaṃsati	verb
अतिप्रसर्सृते	atiprasarsṛte	verb
अतिबाधते	atibādhate	verb
अतिब्रवीति	atibravīti	verb
अतिब्रिहति	atibrihati	verb
अतिभवति	atibhavati	verb
अतिभूषति	atibhūṣati	verb
अतिमन्यते	atimanyate	verb
अतिमुच्यते	atimucyate	verb
अतियाति	atiyāti	verb
अतिरिच्यते	atiricyate	verb
अतिरेचयति	atirecayati	verb
अतिरेच्यते	atirecyate	verb
अतिरोहति	atirohati	verb
अतिलङ्घयति	atilaṅghayati	verb
अतिवदति	ativadati	verb
अतिवयति	ativayati	verb
अतिवर्धते	ativardhate	verb
अतिवाहयति	ativāhayati	verb
अतिविलोडयति	ativiloḍayati	verb
अतिवेति	ativeti	verb
अतिशङ्कते	atiśaṅkate	verb
अतिशिनष्टि	atiśinaṣṭi	verb
अतिशोभते	atiśobhate	verb
अतिश्लिष्यति	atiśliṣyati	verb
अतिसन्दधाति	atisandadhāti	verb
अतिसार्यते	atisāryate	verb
अतिसृजति	atisṛjati	verb
अतिस्रंसते	atisraṃsate	verb
अत्यर्जति / -ते	atyarjati / -te	verb
अत्यस्यति	atyasyati	verb
अत्यायतते	atyāyatate	verb
अत्युक्षति / -ते	atyukṣati / -te	verb
अत्युत्क्रामति	atyutkrāmati	verb
अत्यूहति / -ते	atyūhati / -te	verb
अत्येति	atyeti	verb
अत्स्यति	atsyati	verb
अथर्य	atharya	verb
अदृप्त	adṛpta	verb
अधिईक्षते	adhiīkṣate	verb
अधिकतमं करोति	adhikatamaṃ karoti	verb
अधि करोति	adhi karoti	verb
अधिकारं करोति	adhikāraṃ karoti	verb
अधिक्रामति	adhikrāmati	verb
अधिगणयति	adhigaṇayati	verb
अधिगापयति	adhigāpayati	verb
अधिजिगमिषति	adhijigamiṣati	verb
अधिजिगाति	adhijigāti	verb
अधिदिशति	adhidiśati	verb
अधिनिदधाति	adhinidadhāti	verb
अधिनिर्मुच्यते	adhinirmucyate	verb
अधिप्रधावति	adhipradhāvati	verb
अधिबधते	adhibadhate	verb
अधिभुनक्ति	adhibhunakti	verb
अधिमन्यते	adhimanyate	verb
अधियतते	adhiyatate	verb
अधियाति	adhiyāti	verb
अधियुनक्ति	adhiyunakti	verb
अधिरोपयति	adhiropayati	verb
अधिलिखति	adhilikhati	verb
अधिवपति / -ते	adhivapati / -te	verb
अधिवस्ते	adhivaste	verb
अधिविन्दति	adhivindati	verb
अधिवियातयति	adhiviyātayati	verb
अधिव्ययति	adhivyayati	verb
अधिसर्पति	adhisarpati	verb
अधिसंवर्तते	adhisaṃvartate	verb
अधिस्पृशति	adhispṛśati	verb
अधिस्रवति	adhisravati	verb
अधिहरति	adhiharati	verb
अधीषति	adhīṣati	verb
अध्याक्रामति	adhyākrāmati	verb
अध्यासजति	adhyāsajati	verb
अध्यासीदति / -ते	adhyāsīdati / -te	verb
अध्युद्यच्छति	adhyudyacchati	verb
अध्यृध्नोति	adhyṛdhnoti	verb
अध्येति	adhyeti	verb
अध्येधते	adhyedhate	verb
अध्येषण	adhyeṣaṇa	verb
अनक्ति	anakti	verb
अनति	anati	verb
अनर्थं करोति	anarthaṃ karoti	verb
अनशनं करोति	anaśanaṃ karoti	verb
अनुकम्पते	anukampate	verb
अनुकम्पयति	anukampayati	verb
अनुकरणं करोति	anukaraṇaṃ karoti	verb
अनुकरोति	anukaroti	verb
अनुकर्षति	anukarṣati	verb
अनुकल्पयति	anukalpayati	verb
अनुक्रोशति	anukrośati	verb
अनुक्षयति	anukṣayati	verb
अनुख्याति	anukhyāti	verb
अनुगच्छति	anugacchati	verb
अनुगायति	anugāyati	verb
अनुगाहते	anugāhate	verb
अनुगुणयति	anuguṇayati	verb
अनुगृह्णाति	anugṛhṇāti	verb
अनुग्रहं करोति	anugrahaṃ karoti	verb
अनुघट्टयति	anughaṭṭayati	verb
अनुचरति	anucarati	verb
अनुचिनोति	anucinoti	verb
अनुचिन्तयति	anucintayati	verb
अनुछिनत्ति	anuchinatti	verb
अनुजग्मुः	anujagmuḥ	Perfect
अनुजपति	anujapati	verb
अनुजयति	anujayati	verb
अनुजल्पते	anujalpate	verb
अनुजिज्ञासति	anujijñāsati	verb
अनुजिज्ञासते	anujijñāsate	verb
अनुजिहिते	anujihite	verb
अनुजुजोषति	anujujoṣati	verb
अनुज्ञप्ति	anujñapti	verb
अनुतपति	anutapati	verb
अनुतरति	anutarati	verb
अनुतापयति	anutāpayati	verb
अनुतिष्ठति	anutiṣṭhati	verb
अनुतूलयति	anutūlayati	verb
अनुददाति	anudadāti	verb
अनुदधति	anudadhati	verb
अनुदधाति	anudadhāti	verb
अनुदृमति	anudṛmati	verb
अनुद्रवति	anudravati	verb
अनुद्विषति	anudviṣati	verb
अनुधन्वति	anudhanvati	verb
अनुधावति	anudhāvati	verb
अनुध्यायति	anudhyāyati	verb
अनुनन्दति	anunandati	verb
अनुनयति	anunayati	verb
अनुनादयति	anunādayati	verb
अनुनिक्षति	anunikṣati	verb
अनुनिर्वाति	anunirvāti	verb
अनुनिशामयति	anuniśāmayati	verb
अनुन्यस्यति	anunyasyati	verb
अनुपचति	anupacati	verb
अनुपचते	anupacate	verb
अनुपठति	anupaṭhati	verb
अनुपतति	anupatati	verb
अनुपदति	anupadati	verb
अनुपरागच्छति	anuparāgacchati	verb
अनुपरापतति	anuparāpatati	verb
अनुपरिकिरति	anuparikirati	verb
अनुपरिगृह्णाति	anuparigṛhṇāti	verb
अनुपर्याजिगाति	anuparyājigāti	verb
अनुपर्यावर्तते	anuparyāvartate	verb
अनुपश्यति / -ते	anupaśyati /  -te	verb
अनुपातयति	anupātayati	verb
अनुपालयति	anupālayati	verb
अनुपिबति	anupibati	verb
अनुपृच्छति	anupṛcchati	verb
अनुपोषति	anupoṣati	verb
अनुप्रजनति	anuprajanati	verb
अनुप्रणुदति	anupraṇudati	verb
अनुप्रददाति	anupradadāti	verb
अनुप्रधावति	anupradhāvati	verb
अनुप्रपद्यते	anuprapadyate	verb
अनुप्रपिबति	anuprapibati	verb
अनुप्रभूषति	anuprabhūṣati	verb
अनुप्रमुञ्चति	anupramuñcati	verb
अनुप्रयच्छति	anuprayacchati	verb
अनुप्रयाति	anuprayāti	verb
अनुप्रयुङ्क्ते	anuprayuṅkte	verb
अनुप्ररोहति	anuprarohati	verb
अनुप्रव्रजति	anupravrajati	verb
अनुप्रशोचते	anupraśocate	verb
अनुप्रसजति / -ते	anuprasajati / -te	verb
अनुप्राप्नोति	anuprāpnoti	verb
अनुप्रास्यति	anuprāsyati	verb
अनुप्रैति	anupraiti	verb
अनुप्रोहति	anuprohati	verb
अनुप्लवन्ते	anuplavante	verb
अनुबन्धति / -ते	anubandhati / -te	verb
अनुबाधते	anubādhate	verb
अनुबुध्यते	anubudhyate	verb
अनुब्रवीति	anubravīti	verb
अनुभरति / -ते	anubharati / -te	verb
अनुभवति	anubhavati	verb
अनुभाषते	anubhāṣate	verb
अनुभिनक्ति	anubhinakti	verb
अनुभुनक्ति	anubhunakti	verb
अनुभ्राजते	anubhrājate	verb
अनुमतिं ददाति	anumatiṃ dadāti	verb
अनुमद्यति / ते	anumadyati / te	verb
अनुमन्यते	anumanyate	verb
अनुमानं करोति	anumānaṃ karoti	verb
अनुमायते	anumāyate	verb
अनुमार्जति / -ते	anumārjati / -te	verb
अनुमिमाति	anumimāti	verb
अनुमृशति / -ते	anumṛśati / -te	verb
अनुमोदते	anumodate	verb
अनुमोदनं करोति	anumodanaṃ karoti	verb
अनुयच्छति	anuyacchati	verb
अनुयाति	anuyāti	verb
अनुयोजति	anuyojati	verb
अनुरवीति	anuravīti	verb
अनुरिच्यते	anuricyate	verb
अनुरुध्यति	anurudhyati	verb
अनुरुध्यते	anurudhyate	verb
अनुरुहति	anuruhati	verb
अनुरुहते	anuruhate	verb
अनुरोदिति	anuroditi	verb
अनुरोधं करोति	anurodhaṃ karoti	verb
अनुरोहति	anurohati	verb
अनुरोहते	anurohate	verb
अनुलग्नी करोति	anulagnī karoti	verb
अनुवदति	anuvadati	verb
अनुवर्तते	anuvartate	verb
अनुवसति	anuvasati	verb
अनुवाति	anuvāti	verb
अनुविकसति	anuvikasati	verb
अनुविकिरति	anuvikirati	verb
अनुविक्रामति	anuvikrāmati	verb
अनुविचिन्तयति	anuvicintayati	verb
अनुविचिन्तयते	anuvicintayate	verb
अनुवितनुते	anuvitanute	verb
अनुवितनोति	anuvitanoti	verb
अनुविदधाति	anuvidadhāti	verb
अनुविधत्ते	anuvidhatte	verb
अनुविधीयते	anuvidhīyate	verb
अनुविनर्दति	anuvinardati	verb
अनुविनर्दते	anuvinardate	verb
अनुविनशति	anuvinaśati	verb
अनुविनश्यति	anuvinaśyati	verb
अनुविनादयति	anuvinādayati	verb
अनुविन्दति	anuvindati	verb
अनुविन्दते	anuvindate	verb
अनुविभवति	anuvibhavati	verb
अनुविमृशति	anuvimṛśati	verb
अनुविलीयते	anuvilīyate	verb
अनुविलोकयति	anuvilokayati	verb
अनुविहन्ति	anuvihanti	verb
अनुवीक्षते	anuvīkṣate	verb
अनुवेत्ति	anuvetti	verb
अनुव्याहरति	anuvyāharati	verb
अनुव्याहरते	anuvyāharate	verb
अनुव्यूहति	anuvyūhati	verb
अनुव्रजति	anuvrajati	verb
अनुशक्नोति	anuśaknoti	verb
अनुशीलयति	anuśīlayati	verb
अनुशृन्थति	anuśṛnthati	verb
अनुश्रथयते	anuśrathayate	verb
अनुष्ठति	anuṣṭhati	verb
अनुष्ठते	anuṣṭhate	verb
अनुष्यदे	anuṣyade	verb
अनुसञ्चरति	anusañcarati	verb
अनुसञ्चिन्तयति	anusañcintayati	verb
अनुसञ्ज्वरति	anusañjvarati	verb
अनुसन्तनोति	anusantanoti	verb
अनुसन्तरति	anusantarati	verb
अनुसन्दधाति	anusandadhāti	verb
अनुसन्दधात्ते	anusandadhātte	verb
अनुसन्दिशति	anusandiśati	verb
अनुसन्धानं करोति	anusandhānaṃ karoti	verb
अनुसमश्नुते	anusamaśnute	verb
अनुसमश्नोति	anusamaśnoti	verb
अनुसमाचरति	anusamācarati	verb
अनुसमाचरते	anusamācarate	verb
अनुसमादधाति	anusamādadhāti	verb
अनुसमाधत्ते	anusamādhatte	verb
अनुसमारभते	anusamārabhate	verb
अनुसम्पश्यति	anusampaśyati	verb
अनुसम्प्राप्नोति	anusamprāpnoti	verb
अनुसम्भिनत्ति	anusambhinatti	verb
अनुसम्भिन्त्ति	anusambhintti	verb
अनुसम्मन्यति	anusammanyati	verb
अनुसम्मन्यते	anusammanyate	verb
अनुसरति	anusarati	verb
अनुसारयति	anusārayati	verb
अनुसृजति	anusṛjati	verb
अनुसेवते	anusevate	verb
अनुसंयाति	anusaṃyāti	verb
अनुसंरभते	anusaṃrabhate	verb
अनुसंविचरति	anusaṃvicarati	verb
अनुसंस्थापयति	anusaṃsthāpayati	verb
अनुसंस्मरति	anusaṃsmarati	verb
अनुसंहरति	anusaṃharati	verb
अनुस्मरति	anusmarati	verb
अनुस्यति	anusyati	verb
अनुहरति	anuharati	verb
अनुहुङ्करोति	anuhuṅkaroti	verb
अनूत्पतति	anūtpatati	verb
अनूपदस्यति	anūpadasyati	verb
अनूपविशति	anūpaviśati	verb
अन्तरनक्ति	antaranakti	verb
अन्तरयति	antarayati	verb
अन्तरुपात्येति	antarupātyeti	verb
अन्तर्जिगाति	antarjigāti	verb
अन्तर्ज्वलति	antarjvalati	verb
अन्तर्धत्ते	antardhatte	verb
अन्तर्भवति	antarbhavati	verb
अन्तर्वसति	antarvasati	verb
अन्तर्हितम् करोति	antarhitam karoti	verb
अन्ताय करोति	antāya karoti	verb
अन्तःख्याति	antaḥkhyāti	verb
अन्दोलयति	andolayati	verb
अन्यत् करोति	anyat karoti	verb
अन्यथयति	anyathayati	verb
अन्यथा करोति	anyathā karoti	verb
अन्यायं करोति	anyāyaṃ karoti	verb
अन्येन सह आचरति	anyena saha ācarati	verb
अन्वनक्ति	anvanakti	verb
अन्वयुः	anvayuḥ	Perfect
अन्वर्चयति	anvarcayati	verb
अन्वर्तते	anvartate	verb
अन्वव करोति	anvava karoti	verb
अन्ववचरति	anvavacarati	verb
अन्ववति	anvavati	verb
अन्ववदधाति	anvavadadhāti	verb
अन्वश्नुते	anvaśnute	verb
अन्वश्नोति	anvaśnoti	verb
अन्वा करोति	anvā karoti	verb
अन्वाचमति	anvācamati	verb
अन्वाचरति	anvācarati	verb
अन्वाजे करोति	anvāje karoti	verb
अन्वारोहति	anvārohati	verb
अन्वाशेते	anvāśete	verb
अन्वाहरति	anvāharati	verb1
अन्वाहिण्डति	anvāhiṇḍati	verb
अन्वेतवे	anvetave	verb
अन्वेषणं करोति	anveṣaṇaṃ karoti	verb
अपकिरति	apakirati	verb
अपगच्छति	apagacchati	verb
अपचरति	apacarati	verb
अपछिनत्ति	apachinatti	verb
अपजानीते	apajānīte	verb
अपदधाति	apadadhāti	verb
अपदिशति	apadiśati	verb
अपधावति	apadhāvati	verb
अपधृष्णोति	apadhṛṣṇoti	verb
अपध्वंसति	apadhvaṃsati	verb
अपनयति	apanayati	verb
अपनिदधाति	apanidadhāti	verb
अपप्रयति	apaprayati	verb
अपभजति	apabhajati	verb1
अपमानयति	apamānayati	verb
अपयुयोति	apayuyoti	verb
अपरज्जति	aparajjati	verb
अपरज्यते	aparajyate	verb
अपस्किरते	apaskirate	verb
अपाकरोति	apākaroti	verb
अपायति	apāyati	verb
अपावर्तते	apāvartate	verb
अपाश्रयति	apāśrayati	verb
अपाश्रयते	apāśrayate	verb
अपि करोति	api karoti	verb
अपिगृह्णाति	apigṛhṇāti	verb
अपिदधाति	apidadhāti	verb
अपिम्रिष्यते	apimriṣyate	verb
अपिसङ्गृभायति	apisaṅgṛbhāyati	verb
अपुवायते	apuvāyate	verb
अपैति	apaiti	verb
अपोहाति	apohāti	verb
अपोहाते	apohāte	verb
अप्यस्ति	apyasti	verb
अप्योति	apyoti	verb
अभवत्	abhavat	verb
अभवन्	abhavan	verb
अभिकम्पते	abhikampate	verb
अभिकरोति	abhikaroti	verb
अभिकर्षति	abhikarṣati	verb
अभिकाङ्क्षति	abhikāṅkṣati	verb
अभिकुष्णाति	abhikuṣṇāti	verb
अभिक्षिपति	abhikṣipati	verb
अभिगच्छति	abhigacchati	verb
अभिगर्जति	abhigarjati	verb
अभिगोपायति	abhigopāyati	verb
अभिग्रिह्णाति	abhigrihṇāti	verb
अभिचरति	abhicarati	verb
अभिचिह्नयति	abhicihnayati	verb
अभिजानाति	abhijānāti	verb
अभिजिघ्रति	abhijighrati	verb
अभिजुहोति	abhijuhoti	verb
अभिज्वलति	abhijvalati	verb
अभिज्वलयति	abhijvalayati	verb
अभितनुते	abhitanute	verb8
अभितनोति	abhitanoti	verb8
अभितर्जयति	abhitarjayati	verb
अभितिष्टति	abhitiṣṭati	verb
अभितृणत्ति	abhitṛṇatti	verb
अभिदत्ते	abhidatte	verb
अभिददाति	abhidadāti	verb
अभिदधाति	abhidadhāti	verb
अभिदूष्यति	abhidūṣyati	verb
अभिद्रुह्यति	abhidruhyati	verb
अभिधावति	abhidhāvati	verb
अभिध्यायति	abhidhyāyati	verb
अभिनन्दनं करोति	abhinandanaṃ karoti	verb
अभिनयति	abhinayati	verb
अभिनिमन्त्रयति	abhinimantrayati	verb
अभिनिमन्त्रयते	abhinimantrayate	verb
अभिनिम्रोचति	abhinimrocati	verb
अभिनिर्णुदति	abhinirṇudati	verb
अभिनिर्दिशति	abhinirdiśati	verb
अभिनिर्मिनोति	abhinirminoti	verb
अभिनिर्वर्तते	abhinirvartate	verb
अभिनिवर्तते	abhinivartate	verb
अभिनिविशते	abhiniviśate	verb
अभिनिशाम्यति	abhiniśāmyati	verb
अभिनिषिञ्चति	abhiniṣiñcati	verb
अभिनिष्पदति	abhiniṣpadati	verb
अभिनिस्यन्दते	abhinisyandate	verb
अभिनिहन्ति	abhinihanti	verb
अभिनुदति	abhinudati	verb
अभिपतति	abhipatati	verb
अभिपरिगृह्णाति	abhiparigṛhṇāti	verb
अभिपर्येहि	abhiparyehi	verb
अभिपवते	abhipavate	verb
अभिपश्यति	abhipaśyati	verb
अभिपाति	abhipāti	verb
अभिपीडयति	abhipīḍayati	verb
अभिप्रगाहते	abhipragāhate	verb
अभिप्रजायते	abhiprajāyate	verb
अभिप्रजाष्यते	abhiprajāṣyate	verb
अभिप्रजिहीते	abhiprajihīte	verb
अभिप्रज्वलति	abhiprajvalati	verb
अभिप्रणक्षति	abhipraṇakṣati	verb
अभिप्रतिपिनष्टि	abhipratipinaṣṭi	verb
अभिप्रतिष्टति	abhipratiṣṭati	verb
अभिप्रद्रवते	abhipradravate	verb
अभिप्रनवति	abhipranavati	verb
अभिप्रपद्यते	abhiprapadyate	verb
अभिप्रपश्यति	abhiprapaśyati	verb
अभिप्रबुध्यते	abhiprabudhyate	verb
अभिप्रभवति	abhiprabhavati	verb
अभिप्रमन्	abhipraman	verb
अभिप्रमन्दति	abhipramandati	verb
अभिप्रमृशति	abhipramṛśati	verb
अभिप्रयाति	abhiprayāti	verb
अभिप्रय्ङ्क्ते	abhiprayṅkte	verb
अभिप्ररोहति	abhiprarohati	verb
अभिप्रवते	abhipravate	verb
अभिप्रवर्तते	abhipravartate	verb
अभिप्रवेपते	abhipravepate	verb
अभिप्रशंसति	abhipraśaṃsati	verb
अभिप्रशंसते	abhipraśaṃsate	verb
अभिप्रस्तृणाति	abhiprastṛṇāti	verb
अभिप्रस्तृणीते	abhiprastṛṇīte	verb
अभिप्रस्तृणुते	abhiprastṛṇute	verb
अभिप्रस्तृणोति	abhiprastṛṇoti	verb
अभिप्रहन्ति	abhiprahanti	verb
अभिप्राणीति	abhiprāṇīti	verb
अभिप्रेष्यति	abhipreṣyati	verb
अभिप्लवते	abhiplavate	verb
अभिबाधते	abhibādhate	verb
अभिबिपति	abhibipati	verb
अभिभर्त्सयते	abhibhartsayate	verb
अभिभवति	abhibhavati	verb
अभिभाति	abhibhāti	verb
अभिभाषते	abhibhāṣate	verb
अभिभूषति	abhibhūṣati	verb
अभिमन्त्रयते	abhimantrayate	verb
अभिमन्दति	abhimandati	verb
अभिमन्दते	abhimandate	verb
अभिमन्यते	abhimanyate	verb
अभिमर्दति	abhimardati	verb
अभिमाति	abhimāti	verb
अभिमाद्यति	abhimādyati	verb
अभिमायते	abhimāyate	verb
अभिमार्जति	abhimārjati	verb
अभिमिथति	abhimithati	verb
अभिमिथते	abhimithate	verb
अभिमिमीते	abhimimīte	verb
अभिमिहति	abhimihati	verb
अभिमुखयति	abhimukhayati	verb
अभिमुञ्चति	abhimuñcati	verb
अभिमुञ्चते	abhimuñcate	verb
अभिमृक्षति	abhimṛkṣati	verb
अभिमृद्	abhimṛd	verb
अभिमेहति	abhimehati	verb
अभिम्रक्षति	abhimrakṣati	verb
अभियाचति	abhiyācati	verb
अभियाचते	abhiyācate	verb
अभियाति	abhiyāti	verb
अभियुङ्क्ते	abhiyuṅkte	verb
अभियुञ्जति	abhiyuñjati	verb
अभिरक्षते	abhirakṣate	verb
अभिरमते	abhiramate	verb
अभिराजति	abhirājati	verb
अभिरायति	abhirāyati	verb
अभिरेषति	abhireṣati	verb
अभिरोचते	abhirocate	verb
अभिरौति	abhirauti	verb
अभिलषति	abhilaṣati	verb
अभिलुम्पति	abhilumpati	verb
अभिलुम्पते	abhilumpate	verb
अभिवक्ति	abhivakti	verb
अभिवदति	abhivadati	verb
अभिवधयति	abhivadhayati	verb
अभिवन्दते	abhivandate	verb
अभिवर्धते	abhivardhate	verb
अभिवर्षति	abhivarṣati	verb
अभिवल्गति	abhivalgati	verb
अभिवाति	abhivāti	verb
अभिविजङ्गहे	abhivijaṅgahe	verb
अभिविज्वलति	abhivijvalati	verb
अभिविपश्यति	abhivipaśyati	verb
अभिविबुध्यते	abhivibudhyate	verb
अभिविभजते	abhivibhajate	verb
अभिविभाति	abhivibhāti	verb
अभिविमथति	abhivimathati	verb
अभिवियाति	abhiviyāti	verb
अभिविराजति	abhivirājati	verb
अभिविराजते	abhivirājate	verb
अभिविहरति	abhiviharati	verb
अभिवीक्षते	abhivīkṣate	verb
अभिवेति	abhiveti	verb
अभिवेवेक्ति	abhivevekti	verb
अभिव्याहरति	abhivyāharati	verb
अभिशङ्कते	abhiśaṅkate	verb
अभिशब्दयति / -ति	abhiśabdayati / -ti	verb
अभिशाम्यति	abhiśāmyati	verb
अभिशासति	abhiśāsati	verb
अभिशेते	abhiśete	verb
अभिशोचति	abhiśocati	verb
अभिशंसति	abhiśaṃsati	verb
अभिश्रदधाति	abhiśradadhāti	verb
अभिश्रयति	abhiśrayati	verb
अभिश्वसिति	abhiśvasiti	verb
अभिषचते	abhiṣacate	verb
अभिषजति	abhiṣajati	verb
अभिषहति	abhiṣahati	verb
अभिषहते	abhiṣahate	verb
अभिषिञ्चति	abhiṣiñcati	verb
अभिषिञ्चते	abhiṣiñcate	verb
अभिषुण्वति	abhiṣuṇvati	verb
अभिषुवति	abhiṣuvati	verb
अभिष्टौति	abhiṣṭauti	verb
अभिष्यन्दते	abhiṣyandate	verb
अभिसङ्क्षिपति	abhisaṅkṣipati	verb
अभिसङ्ख्याति	abhisaṅkhyāti	verb
अभिसङ्गच्छते	abhisaṅgacchate	verb
अभिसञ्चिन्तयति	abhisañcintayati	verb
अभिसञ्चूर्णयति	abhisañcūrṇayati	verb
अभिसञ्जानाति	abhisañjānāti	verb
अभिसञ्जानीते	abhisañjānīte	verb
अभिसञ्ज्वरति	abhisañjvarati	verb
अभिसन्तनोति	abhisantanoti	verb
अभिसन्त्यजति	abhisantyajati	verb
अभिसन्दधाति	abhisandadhāti	verb
अभिसपति	abhisapati	verb
अभिसमस्यति	abhisamasyati	verb
अभिसमिति	abhisamiti	verb
अभिसमिन्धे	abhisamindhe	verb
अभिसमियर्ति	abhisamiyarti	verb
अभिसमृणोति	abhisamṛṇoti	verb
अभिसमृण्वति	abhisamṛṇvati	verb
अभिसम्प्रजहाति	abhisamprajahāti	verb
अभिसम्प्रेक्षते	abhisamprekṣate	verb
अभिसम्प्लवते	abhisamplavate	verb
अभिसम्बध्नाति	abhisambadhnāti	verb
अभिसम्बध्यते	abhisambadhyate	verb
अभिसम्भवति	abhisambhavati	verb
अभिसम्रिच्छति	abhisamricchati	verb
अभिसरति	abhisarati	verb
अभिसर्पति	abhisarpati	verb
अभिसान्त्वयति	abhisāntvayati	verb
अभिसावकीयति	abhisāvakīyati	verb
अभिसिषक्ति	abhisiṣakti	verb
अभिसीदति	abhisīdati	verb
अभिसृजति	abhisṛjati	verb
अभिसंनमति	abhisaṃnamati	verb
अभिसंनयति	abhisaṃnayati	verb
अभिसंनवते	abhisaṃnavate	verb
अभिसंनह्यति	abhisaṃnahyati	verb
अभिसंयच्छति	abhisaṃyacchati	verb
अभिसंयाति	abhisaṃyāti	verb
अभिसंरभते	abhisaṃrabhate	verb
अभिसंवसते	abhisaṃvasate	verb
अभिसंवित्ते	abhisaṃvitte	verb
अभिसंविशति	abhisaṃviśati	verb
अभिसंविशते	abhisaṃviśate	verb
अभिसंवीषते	abhisaṃvīṣate	verb
अभिसंवृणुते	abhisaṃvṛṇute	verb
अभिसंवृणोति	abhisaṃvṛṇoti	verb
अभिसंवेत्ति	abhisaṃvetti	verb
अभिसंश्रयति	abhisaṃśrayati	verb
अभिसंसरति	abhisaṃsarati	verb
अभिसंस्करोति	abhisaṃskaroti	verb
अभिसंस्तौति	abhisaṃstauti	verb
अभिसंस्पृशति	abhisaṃspṛśati	verb
अभिसंस्मरति	abhisaṃsmarati	verb
अभिसंस्वजते	abhisaṃsvajate	verb
अभिसंस्वरति	abhisaṃsvarati	verb
अभिसंहन्ति	abhisaṃhanti	verb
अभिस्कन्दति	abhiskandati	verb
अभिस्पृशति	abhispṛśati	verb
अभिस्वरति	abhisvarati	verb
अभिहन्ति	abhihanti	verb
अभिहरति	abhiharati	verb
अभीन्दधे	abhīndadhe	verb
अभ्यजति	abhyajati	verb
अभ्यञ्जते	abhyañjate	verb
अभ्यञ्जयति	abhyañjayati	verb
अभ्यतिक्रमति	abhyatikramati	verb
अभ्यतिवदति	abhyativadati	verb
अभ्यत्यर्जति	abhyatyarjati	verb
अभ्यनक्ति	abhyanakti	verb
अभ्यनुजानाति	abhyanujānāti	verb
अभ्यनुयुनक्ति	abhyanuyunakti	verb
अभ्यनुशास्ति	abhyanuśāsti	verb
अभ्यनुसरति	abhyanusarati	verb
अभ्यन्तरी करोति	abhyantarī karoti	verb
अभ्यन्तरीकरोति	abhyantarīkaroti	verb
अभ्यर्थयते	abhyarthayate	verb
अभ्यर्दति	abhyardati	verb
अभ्यर्षति	abhyarṣati	verb
अभ्यवकीर्यते	abhyavakīryate	verb
अभ्यवगाहते	abhyavagāhate	verb
अभ्यवचरति	abhyavacarati	verb
अभ्यवज्वलति	abhyavajvalati	verb
अभ्यवति	abhyavati	verb
अभ्यवदधाति	abhyavadadhāti	verb
अभ्यवमन्यते	abhyavamanyate	verb
अभ्यवसरति	abhyavasarati	verb
अभ्यवस्कन्दति	abhyavaskandati	verb
अभ्यवैति	abhyavaiti	verb
अभ्यश्नोति	abhyaśnoti	verb
अभ्यस्ति	abhyasti	verb
अभ्यस्ते	abhyaste	verb
अभ्यस्यति	abhyasyati	verb
अभ्याक्रोशति	abhyākrośati	verb
अभ्याख्याति	abhyākhyāti	verb
अभ्याचरति	abhyācarati	verb
अभ्यातपति	abhyātapati	verb
अभ्यादत्ते	abhyādatte	verb
अभ्याददाति	abhyādadāti	verb
अभ्यानृत्यति	abhyānṛtyati	verb
अभ्यायच्छति	abhyāyacchati	verb
अभ्यायच्छते	abhyāyacchate	verb
अभ्यायति	abhyāyati	verb
अभ्यारभ्ति	abhyārabhti	verb
अभ्यारभ्ते	abhyārabhte	verb
अभ्यारोहति	abhyārohati	verb
अभ्यावधति	abhyāvadhati	verb
अभ्यावहति	abhyāvahati	verb
अभ्याविशति	abhyāviśati	verb
अभ्यासिञ्चति	abhyāsiñcati	verb
अभ्यासिदति	abhyāsidati	verb
अभ्यासं करोति	abhyāsaṃ karoti	verb
अभ्यासं करोति	abhyāsṃ karoti	verb
अभ्याहते	abhyāhate	verb
अभ्याह्वते	abhyāhvate	verb
अभ्युक्षते	abhyukṣate	verb
अभ्युच्यति	abhyucyati	verb
अभ्युत्क्रमति	abhyutkramati	verb
अभ्युत्क्रोशति	abhyutkrośati	verb
अभ्युत्सर्जति	abhyutsarjati	verb
अभ्युत्सहते	abhyutsahate	verb
अभ्युत्स्मयते	abhyutsmayate	verb
अभ्युदतिष्ठति	abhyudatiṣṭhati	verb
अभ्युदूहति	abhyudūhati	verb
अभ्युद्द्रवति	abhyuddravati	verb
अभ्युद्धरति	abhyuddharati	verb
अभ्युन्नयति	abhyunnayati	verb
अभ्युपपद्यते	abhyupapadyate	verb
अभ्युपमन्त्रयते	abhyupamantrayate	verb
अभ्युपलक्षते	abhyupalakṣate	verb
अभ्युपाकरोति	abhyupākaroti	verb
अभ्युपाददाति	abhyupādadāti	verb
अभ्युपावहरति	abhyupāvaharati	verb
अभ्युपाहरति	abhyupāharati	verb
अभ्युपेक्षते	abhyupekṣate	verb
अभ्युपैति	abhyupaiti	verb
अभ्युपैहि	abhyupaihi	verb
अभ्यूर्णोति	abhyūrṇoti	verb
अभ्यूहति	abhyūhati	verb
अभ्यूहते	abhyūhate	verb
अभ्येति	abhyeti	verb
अभ्योषति	abhyoṣati	verb
अभ्रायते	abhrāyate	verb
अमरीभवति	amarībhavati	verb
अमलयति	amalayati	verb
अमलीकरोति	amalīkaroti	verb
अमित्रयति	amitrayati	verb
अमित्रायते	amitrāyate	verb
अमिथ्याकरोति	amithyākaroti	verb
अमुकनाम्ना रक्षति	amukanāmnā rakṣati	verb
अमृतायते	amṛtāyate	verb
अम्बर्यति	ambaryati	verb
अरङ्करोति	araṅkaroti	verb
अरङ्गच्छति	araṅgacchati	verb
अरजायति	arajāyati	verb
अरर्यति	araryati	verb
अरातियति	arātiyati	verb
अरिष्यति	ariṣyati	future
अर्घम् निर्धारयति	argham nirdhārayati	verb
अर्चिष्यति	arciṣyati	future
अर्जति	arjati	verb
अर्जते	arjate	verb
अर्जिष्यति	arjiṣyati	future
अर्णोति	arṇoti	verb
अर्थयिष्यति	arthayiṣyati	future
अर्थापयति	arthāpayati	verb
अर्पणं करोति	arpaṇaṃ karoti	verb
अर्बति	arbati	verb
अलङ्करोति	alaṅkaroti	verb
अलति	alati	verb
अलभत्	alabhat	verb
अलिखत्	alikhat	verb
अल्पयति	alpayati	verb
अल्पाहारं करोति	alpāhāraṃ karoti	verb
अल्पी करोति	alpī karoti	verb
अल्पीभवति	alpībhavati	verb
अवकर्तति	avakartati	verb
अवकर्षति	avakarṣati	verb
अवकल्पते	avakalpate	verb
अवकिरति	avakirati	verb
अवकुत्सयति	avakutsayati	verb
अवकुष्णति	avakuṣṇati	verb
अवकूजति	avakūjati	verb
अवकूलति	avakūlati	verb
अवक्रमति	avakramati	verb
अवक्रीणीते	avakrīṇīte	verb
अवक्षयति	avakṣayati	verb
अवक्षिपति	avakṣipati	verb
अवक्ष्णौति	avakṣṇauti	verb
अवखण्डयति	avakhaṇḍayati	verb
अवगच्छति	avagacchati	verb
अवगमयति	avagamayati	verb
अवगाहते	avagāhate	verb
अवगुण्ठयति	avaguṇṭhayati	verb
अवगूहति	avagūhati	verb
अवगूहते	avagūhate	verb
अवघर्षति	avagharṣati	verb
अवचिनोति	avacinoti	verb
अवच्छादयति	avacchādayati	verb
अवच्छ्यति	avacchyati	verb
अवजयति	avajayati	verb
अवजानाति	avajānāti	verb
अवजिगाति	avajigāti	verb
अवजिघ्रति	avajighrati	verb
अवज्रिम्भते	avajrimbhate	verb
अवतनोति	avatanoti	verb
अवतपति	avatapati	verb
अवतर्णं करोति	avatarṇaṃ karoti	verb
अवतिष्ठति	avatiṣṭhati	verb
अवतिष्ठते	avatiṣṭhate	verb
अवतृणत्ति	avatṛṇatti	verb
अवत्वेषति	avatveṣati	verb
अवत्सरति	avatsarati	verb
अवदधाति	avadadhāti	verb
अवदयते	avadayate	verb
अवदहति	avadahati	verb
अवदिधीते	avadidhīte	verb
अवदीप्यते	avadīpyate	verb
अवदृश्यते	avadṛśyate	verb
अवदेग्धि	avadegdhi	verb
अवद्यति	avadyati	verb
अवधमति	avadhamati	verb
अवधापयति	avadhāpayati	verb
अवधावति	avadhāvati	verb
अवधीयते	avadhīyate	verb
अवधूनोति	avadhūnoti	verb
अवध्यायति	avadhyāyati	verb
अवध्वंसते	avadhvaṃsate	verb
अवनक्षति	avanakṣati	verb
अवनशति	avanaśati	verb
अवनिजे	avanije	verb
अवपतति	avapatati	verb
अवपीडयते	avapīḍayate	verb
अवबुध्यते	avabudhyate	verb
अवभरति	avabharati	verb
अवभरते	avabharate	verb
अवभर्त्सयते	avabhartsayate	verb
अवभाति	avabhāti	verb
अवभासते	avabhāsate	verb
अवभिनत्ति	avabhinatti	verb
अवभुजति	avabhujati	verb
अवमज्जति	avamajjati	verb
अवमन्थति	avamanthati	verb
अवमन्यते	avamanyate	verb
अवमार्ष्टि	avamārṣṭi	verb
अवमृद्राति	avamṛdrāti	verb
अवराध्नोति	avarādhnoti	verb
अवरिफति	avariphati	verb
अवरुजति	avarujati	verb
अवरुणद्धि	avaruṇaddhi	verb
अवरोहति	avarohati	verb
अवर्ती	avartī	verb
अवलम्बते	avalambate	verb
अवलिखति	avalikhati	verb
अवलिम्पति	avalimpati	verb
अवलीयते	avalīyate	verb
अवलुञ्चति	avaluñcati	verb
अवलुम्बति	avalumbati	verb
अवलुम्बते	avalumbate	verb
अवलेढि	avaleḍhi	verb
अवलोकते	avalokate	verb
अवलोकयति	avalokayati	verb
अववर्जति	avavarjati	verb
अवविध्यति	avavidhyati	verb
अववेति	avaveti	verb
अवव्रश्चति	avavraścati	verb
अवशर्धयति	avaśardhayati	verb
अवशिशाति	avaśiśāti	verb
अवशिष्यते	avaśiṣyate	verb
अवशृणोति	avaśṛṇoti	verb
अवशेषयति	avaśeṣayati	verb
अवश्चोतति	avaścotati	verb
अवष्टब्नोति	avaṣṭabnoti	verb
अवष्टम्भ्नाति	avaṣṭambhnāti	verb
अवष्टम्भ्नोति	avaṣṭambhnoti	verb
अवष्वणति	avaṣvaṇati	verb
अवसज्जति	avasajjati	verb
अवसज्जते	avasajjate	verb
अवसर्पति	avasarpati	verb
अवसिञ्चति	avasiñcati	verb
अवसीदति	avasīdati	verb
अवसृजति	avasṛjati	verb
अवसृजते	avasṛjate	verb
अवस्कन्दति	avaskandati	verb
अवस्तृणाति	avastṛṇāti	verb
अवस्पृणोति	avaspṛṇoti	verb
अवस्यति	avasyati	verb
अवस्यन्दते	avasyandate	verb
अवस्वरति	avasvarati	verb
अवहन्ति	avahanti	verb
अवहरति	avaharati	verb
अवहरते	avaharate	verb
अवाकरोति	avākaroti	verb
अवागच्छति	avāgacchati	verb
अवाचिनोति	avācinoti	verb
अवानिति	avāniti	verb
अवापोहति	avāpohati	verb
अवाप्नोति	avāpnoti	verb
अवारोपयति	avāropayati	verb
अवार्छति	avārchati	verb
अवार्जति	avārjati	verb
अवालोचते	avālocate	verb
अवाहरति	avāharati	verb
अवेक्षते	avekṣate	verb
अवेति	aveti	verb
अवोक्षति	avokṣati	verb
अशक्तं करोति	aśaktaṃ karoti	verb
अश्नाति	aśnāti	verb
अश्नीतपिबतीयति	aśnītapibatīyati	verb
अश्नुते	aśnute	verb
अश्रूणि पतयति	aśrūṇi patayati	verb
अश्वस्यस्यति	aśvasyasyati	verb
अश्वीयति	aśvīyati	verb
असुखायते	asukhāyate	verb
असूयति	asūyati	verb
अस्ति	asti	verb
अस्तु	astu	verb
अस्थिरीभवति	asthirībhavati	verb
अहङ्करोति	ahaṅkaroti	verb
अंशयति / -ते	aṃśayati / -te	verb
अंशयति /-ते	aṃśayati /-te	verb
अंशापयति	aṃśāpayati	verb
अंशं प्रास्यति	aṃśaṃ prāsyati	verb
अंहते	aṃhate	verb
अंहयति	aṃhayati	verb
आकम्पते	ākampate	verb
आकर्णयति	ākarṇayati	verb
आकर्षणं करोति	ākarṣaṇaṃ karoti	verb
आकर्षति	ākarṣati	verb
आकलयति	ākalayati	verb
आकाङ्क्षति	ākāṅkṣati	verb
आकाङ्क्षते	ākāṅkṣate	verb
आकाशते	ākāśate	verb
आकाशमुष्टिहननायते	ākāśamuṣṭihananāyate	verb
आकिरति	ākirati	verb
आकुलीकरोति	ākulīkaroti	verb
आकुवते	ākuvate	verb
आकूजति	ākūjati	verb
आकोटयति	ākoṭayati	verb
आक्रन्दति	ākrandati	verb
आक्रन्दते	ākrandate	verb
आक्रमते	ākramate	verb
आक्रामति	ākrāmati	verb
आक्रीयते	ākrīyate	verb
आक्रोशति	ākrośati	verb
आक्षिपति	ākṣipati	verb
आख्याति	ākhyāti	verb
आख्यानयति	ākhyānayati	verb
आगच्छति	āgacchati	verb
आगुरते	āgurate	verb
आग्रथ्नाति	āgrathnāti	verb
आग्रसति	āgrasati	verb
आघूर्णति	āghūrṇati	verb
आघोषति	āghoṣati	verb
आघोषते	āghoṣate	verb
		verb
आचरति	ācarati	verb
आचष्टे	ācaṣṭe	verb
आचामति	ācāmati	verb
आचालयति	ācālayati	verb
आचिकिते	ācikite	verb
आचिनुते	ācinute	verb
आचिनोति	ācinoti	verb
आचुम्बति	ācumbati	verb
आचृतति	ācṛtati	verb
आचेतति	ācetati	verb
आच्छदयते	ācchadayate	verb
आच्छादयति	ācchādayati	verb
आच्छिनत्ति	ācchinatti	verb
आच्छृणत्ति	ācchṛṇatti	verb
आजानाति	ājānāti	verb
आजायते	ājāyate	verb
आजिगाति	ājigāti	verb
आजिघर्ति	ājigharti	verb
आजिन्वति	ājinvati	verb
आजीवति	ājīvati	verb
आज्छति	ājchati	verb
आज्ञापालनं करोति	ājñāpālanaṃ karoti	verb
आज्ञाम् पालयति	ājñām pālayati	verb
आडिवालयति	āḍivālayati	verb
आतक्षति	ātakṣati	verb
आतनक्ति	ātanakti	verb
आतनोषि	ātanoṣi	verb
आतन्वते	ātanvate	verb
आतपति	ātapati	verb
आतपायते	ātapāyate	verb
आतर्जति	ātarjati	verb
आताम्यते	ātāmyate	verb
आतिरते	ātirate	verb
आतिष्ठति	ātiṣṭhati	verb
आतिष्ठते	ātiṣṭhate	verb
आतुदति	ātudati	verb
आतृणत्ति	ātṛṇatti	verb
आतृन्त्ते	ātṛntte	verb
आतोलयति	ātolayati	verb
आतंसति	ātaṃsati	verb
आदघ्नुयात्	ādaghnuyāt	verb
आददृशे	ādadṛśe	verb
आदधाति	ādadhāti	verb
आदभ्नुवति	ādabhnuvati	verb
आदयति / -ते	ādayati / -te	verb
आदरं करोति	ādaraṃ karoti	verb
आदर्षि	ādarṣi	verb
आदाति	ādāti	verb
आदिदेष्टि	ādideṣṭi	verb
आदिशति	ādiśati	verb
आदीद्यति	ādīdyati	verb
आदीधीते	ādīdhīte	verb
आदंशति	ādaṃśati	verb
आद्यति	ādyati	verb
आद्योतति	ādyotati	verb
आद्योतते	ādyotate	verb
आधत्ते	ādhatte	verb
आधमति	ādhamati	verb
आधरति	ādharati	verb
आधर्षति	ādharṣati	verb
आधीकरोति	ādhīkaroti	verb
आधुनोति	ādhunoti	verb
आधुवते	ādhuvate	verb
आध्यायति	ādhyāyati	verb
आनन्दति	ānandati	verb
आनमति	ānamati	verb
आनमयति	ānamayati	verb
आनयति	ānayati	verb
आनयत्	ānayat	verb
आनह्यति	ānahyati	verb
आनृत्यति	ānṛtyati	verb
आपचति	āpacati	verb
आपतति	āpatati	verb
आपद्यते	āpadyate	verb
आपिपर्ति	āpiparti	verb
आपिबति	āpibati	verb
आपिब्दमान	āpibdamāna	verb
आपिंशति	āpiṃśati	verb
आपिंशते	āpiṃśate	verb
आपीतयति	āpītayati	verb
आपृङ्क्ते	āpṛṅkte	verb
आपृच्छते	āpṛcchate	verb
आपृणक्ति	āpṛṇakti	verb
आपृणति	āpṛṇati	verb
आपृणते	āpṛṇate	verb
आपृणाति	āpṛṇāti	verb
आप्नोति	āpnoti	verb
आप्ययते	āpyayate	verb
आप्यायते	āpyāyate	verb
आप्याययति	āpyāyayati	verb
आप्रीणाति	āprīṇāti	verb
आप्रीणीते	āprīṇīte	verb
आप्रुषायति	āpruṣāyati	verb
आप्लवते	āplavate	verb
आप्लवयति	āplavayati	verb
आप्लावयते	āplāvayate	verb
आफणति	āphaṇati	verb
आबध्नाति	ābadhnāti	verb
आबन्धते	ābandhate	verb
आबाधते	ābādhate	verb
आब्रुवते	ābruvate	verb
आभजति	ābhajati	verb
आभजते	ābhajate	verb
आभरति	ābharati	verb
आभवति	ābhavati	verb
आभाति	ābhāti	verb
आभाषते	ābhāṣate	verb
आभासते	ābhāsate	verb
आभिद्यते	ābhidyate	verb
आभूषति	ābhūṣati	verb
आमनति	āmanati	verb
आमन्त्रणं करोति	āmantraṇaṃ karoti	verb
आमन्यते	āmanyate	verb
आमहते	āmahate	verb
आमाथति	āmāthati	verb
आमिनाति	āmināti	verb
आमीनीते	āmīnīte	verb
आमीवति	āmīvati	verb
आमृजति	āmṛjati	verb
आमृद्राति	āmṛdrāti	verb
आमृशति	āmṛśati	verb
आमृष्यते	āmṛṣyate	verb
आयच्छति	āyacchati	verb
आयच्छते	āyacchate	verb
आयजति	āyajati	verb
आयजते	āyajate	verb
आयसति	āyasati	verb
आयस्यति	āyasyati	verb
आयाचति	āyācati	verb
आयाचते	āyācate	verb
आयाति	āyāti	verb
आयापयति	āyāpayati	verb
आयुजति	āyujati	verb
आयुञ्जते	āyuñjate	verb
आयुध्यति	āyudhyati	verb
आयुनक्ति	āyunakti	verb
आयुवते	āyuvate	verb
आयोजनं करोति	āyojanaṃ karoti	verb
आरक्षति	ārakṣati	verb
आरटति	āraṭati	verb
आरपति	ārapati	verb
आरभ्ति	ārabhti	verb
आरभ्ते	ārabhte	verb
आरमति	āramati	verb
आरम्भति	ārambhati	verb
आरम्भते	ārambhate	verb
आरम्भं करोति	ārambhaṃ karoti	verb
आरसति	ārasati	verb
आरागयति	ārāgayati	verb
आराधयति	ārādhayati	verb
आरिणन्ति	āriṇanti	verb
आरीयते	ārīyate	verb
आरुजति	ārujati	verb
आरुणद्धि	āruṇaddhi	verb
आरोपयति	āropayati	verb
आरोहति	ārohati	verb
आर्च्छति	ārcchati	verb
आर्द्रयति	ārdrayati	verb
आर्द्रीकरोति	ārdrīkaroti	verb
आलक्षयते	ālakṣayate	verb
आलगति	ālagati	verb
आलपति	ālapati	verb
आलभते	ālabhate	verb
आलम्बते	ālambate	verb
आलिखति	ālikhati	verb
आलिङ्गति	āliṅgati	verb
आलिङ्गते	āliṅgate	verb
आलिङ्गयति	āliṅgayati	verb
आलिन्ङ्गनं करोति	ālinṅganaṃ karoti	verb
आलिम्पति	ālimpati	verb
आलिहति	ālihati	verb
आलुम्पति	ālumpati	verb
आलोकते	ālokate	verb
आलोचते	ālocate	verb
आलोचयति	ālocayati	verb
आलोडयति	āloḍayati	verb
आवचते	āvacate	verb
आवञ्चयति	āvañcayati	verb
आवदति	āvadati	verb
आवधति	āvadhati	verb
आवनते	āvanate	verb
आवपति	āvapati	verb
आवयति	āvayati	verb
आवर्तते	āvartate	verb
आवसति	āvasati	verb
आवहति	āvahati	verb
आवहते	āvahate	verb
आवाहनं करोति	āvāhanaṃ karoti	verb
आविध्यति	āvidhyati	verb
आविन्दते	āvindate	verb
आविर्भवति	āvirbhavati	verb
आविलयति	āvilayati	verb
आविवेश	āviveśa	Perfect
आविवेश	āvivesha	verb
आविशति	āviśati	verb
आविष्करोति	āviṣkaroti	verb
आविहन्ति	āvihanti	verb
आवृङ्क्ते	āvṛṅkte	verb
आवृणुते	āvṛṇute	verb
आवृणोति	āvṛṇoti	verb
आवृश्चति	āvṛścati	verb
आवृश्चते	āvṛścate	verb
आवृहते	āvṛhate	verb
आवेदति	āvedati	verb
आवेशयति	āveśayati	verb
आव्र्श्च्यते	āvrścyate	verb
आशक्नोति	āśaknoti	verb
आशङ्कते	āśaṅkate	verb
आशास्ते	āśāste	verb
आशुषते	āśuṣate	verb
आशृउणोति	āśṛuṇoti	verb
आशृणुते	āśṛṇute	verb
आशंसति	āśaṃsati	verb
आशंसते	āśaṃsate	verb
आश्रयति	āśrayati	verb
आश्रयते	āśrayate	verb
आश्रीणति	āśrīṇati	verb
आश्रीणीते	āśrīṇīte	verb
आश्रौअतो	āśrauato	verb
आश्लिषति	āśliṣati	verb
आश्लिष्यति	āśliṣyati	verb
आश्लिष्यते	āśliṣyate	verb
आश्वसति	āśvasati	verb
आश्वसते	āśvasate	verb
आश्वसिति	āśvasiti	verb
आसङ्गृह्णति	āsaṅgṛhṇati	verb
आसञ्जति	āsañjati	verb
आसन्	āsan	verb
आसम्	āsam	verb
आसिञ्चते	āsiñcate	verb
आसिनाति	āsināti	verb
आसिनोति	āsinoti	verb
आसीत्	āsīt	verb
आसीदति	āsīdati	verb
आसीदते	āsīdate	verb
आसुनोति	āsunoti	verb
आसूवति	āsūvati	verb
आसृजति	āsṛjati	verb
आसृजते	āsṛjate	verb
आसेधयति	āsedhayati	verb
आसेवति	āsevati	verb
आसेवते	āsevate	verb
आस्कन्दति	āskandati	verb
आस्कन्दं करोति	āskandaṃ karoti	verb
आस्कुनोति	āskunoti	verb
आस्कौति	āskauti	verb
आस्त	āsta	verb
आस्तरते	āstarate	verb
आस्ताम्	āstām	verb
आस्तृणुते	āstṛṇute	verb
आस्तृणोति	āstṛṇoti	verb
आस्तोभति	āstobhati	verb
आस्पन्दते	āspandate	verb
आस्फायते	āsphāyate	verb
आस्यते	āsyate	verb
आस्रवति	āsravati	verb
आस्व	āsva	verb
आस्वनति	āsvanati	verb
आस्विद्यति	āsvidyati	verb
आहते	āhate	verb
आहरणीकरोति	āharaṇīkaroti	verb
आहरति	āharati	verb
आहर्यते	āharyate	verb
आहर्षति	āharṣati	verb
आहारयति	āhārayati	verb
आहिण्डते	āhiṇḍate	verb
आहिन्वते	āhinvate	verb
आहूय	āhūya	verb
आह्नोति	āhnoti	verb
आह्वयति	āhvayati	verb
आह्वयते	āhvayate	verb
आह्वरते	āhvarate	verb
आह्वानं करोति	āhvānaṃ karoti	verb
इङ्गति	iṅgati	verb
इङ्गते	iṅgate	verb
इनक्षति	inakṣati	verb
इनोति	inoti	verb
इन्धनिकरोति	indhanikaroti	verb
इन्वति	invati	verb
इयक्षति	iyakṣati	verb
इयक्षते	iyakṣate	verb
इयस्यते	iyasyate	verb
इयेष	iyeshha	Perfect
इरज्यति	irajyati	verb
इरज्यते	irajyate	verb
इलति	ilati	verb
इषणयते	iṣaṇayate	verb
इषयति	iṣayati	verb
इषयते	iṣayate	verb
इषुध्यति	iṣudhyati	verb
इषुध्यते	iṣudhyate	verb
इष्करोति	iṣkaroti	verb
ईक्षते	īkṣate	verb
ईङ्खति	īṅkhati	verb
ईङ्खयति	īṅkhayati	verb
ईट्टे	īṭṭe	verb
ईर्ष्यति	īrṣyati	verb
ईशे	īśe	verb
ईषति	īṣati	verb
ईषति / -ते	īṣati / -te	verb
ईष्टे	īṣṭe	verb
ईसति	īsati	verb
ईसते	īsate	verb
ईहति	īhati	verb
ईहते	īhate	verb
उक्षण्यति	ukṣaṇyati	verb
उक्षति	ukṣati	verb
उक्षति / -ते	ukṣati / -te	verb
उच्चटति	uccaṭati	verb
उच्चरण्यति	uccaraṇyati	verb
उच्चरति	uccarati	verb
उच्चरते	uccarate	verb
उच्चारणं करोति	uccāraṇaṃ karoti	verb
उच्चिनोति	uccinoti	verb
उच्चिनोते	uccinote	verb
उच्चुलुम्पति	ucculumpati	verb
उच्छलति	ucchalati	verb
उच्छिनत्ति	ucchinatti	verb
उच्छंसति	ucchaṃsati	verb
उच्छ्रयति	ucchrayati	verb
उच्छ्रयते	ucchrayate	verb
उच्छ्रापयति	ucchrāpayati	verb
उच्छ्वञ्चते	ucchvañcate	verb
उच्छ्वसिति	ucchvasiti	verb
उज्जनति	ujjanati	verb
उज्जनते	ujjanate	verb
उज्जयति	ujjayati	verb
उज्जागरति	ujjāgarati	verb
उज्जृम्भते	ujjṛmbhate	verb
उज्ज्वलति	ujjvalati	verb
उज्ज्वलयति	ujjvalayati	verb
उज्ज्वलिति	ujjvaliti	verb
उट्टहासं करोति	uṭṭahāsaṃ karoti	verb
उड्डयते	uḍḍayate	verb
उड्डयनं करोति	uḍḍayanaṃ karoti	verb
उड्डीयते	uḍḍīyate	verb
उत्कचयति	utkacayati	verb
उत्कन्दति	utkandati	verb
उत्कम्पते	utkampate	verb
उत्करोति	utkaroti	verb
उत्कर्षति	utkarṣati	verb
उत्कर्षते	utkarṣate	verb
उत्कलयति	utkalayati	verb
उत्कलापयति	utkalāpayati	verb
उत्कल्पयति	utkalpayati	verb
उत्कषति	utkaṣati	verb
उत्कालयति	utkālayati	verb
उत्काशते	utkāśate	verb
उत्कासते	utkāsate	verb
उत्किरति	utkirati	verb
उत्कीर्तयति	utkīrtayati	verb
उत्कीलयति	utkīlayati	verb
उत्कुचति	utkucati	verb
उत्कुरुते	utkurute	verb
उत्कूजति	utkūjati	verb
उत्कृणत्ति	utkṛṇatti	verb
उत्कोरकयति	utkorakayati	verb
उत्कोशयति	utkośayati	verb
उत्कौति	utkauti	verb
उत्क्रमति	utkramati	verb
उत्क्रमते	utkramate	verb
उत्क्रामते	utkrāmate	verb
उत्क्रोशति	utkrośati	verb
उत्क्लिश्नाति	utkliśnāti	verb
उत्क्वथति	utkvathati	verb
उत्क्षिपति	utkṣipati	verb
उत्क्षिपते	utkṣipate	verb
उत्खनति	utkhanati	verb
उत्खिदति	utkhidati	verb
उत्तपति	uttapati	verb
उत्तपते	uttapate	verb
उत्तरङ्गते	uttaraṅgate	verb
उत्तरति	uttarati	verb
उत्तरयति	uttarayati	verb
उत्तरलायते	uttaralāyate	verb
उत्तरली करोति	uttaralī karoti	verb
उत्तवीति	uttavīti	verb
उत्ताम्यति	uttāmyati	verb
उत्तिरति	uttirati	verb
उत्तिष्ठति	uttiṣṭhati	verb
उत्तिष्ठते	uttiṣṭhate	verb
उत्तेजते	uttejate	verb
उत्तोलयति	uttolayati	verb
उत्थापयति	utthāpayati	verb
उत्पतति	utpatati	verb
उत्पद्यते	utpadyate	verb
उत्पश्यति	utpaśyati	verb
उत्पिपीते	utpipīte	verb
उत्पिबति	utpibati	verb
उत्पीडयति	utpīḍayati	verb
उत्पुनाति	utpunāti	verb
उत्पुनीते	utpunīte	verb
उत्प्रवते	utpravate	verb
उत्प्रासयति	utprāsayati	verb
उत्प्रेक्षते	utprekṣate	verb
उत्प्लवते	utplavate	verb
उत्फलति	utphalati	verb
उत्सर्जति	utsarjati	verb
उत्सर्पति	utsarpati	verb
उत्सहते	utsahate	verb
उत्साहयति	utsāhayati	verb
उत्सिञ्चति	utsiñcati	verb
उत्सिञ्चते	utsiñcate	verb
उत्सिनाति	utsināti	verb
उत्सीदति	utsīdati	verb
उत्सीदते	utsīdate	verb
उत्सुकायते	utsukāyate	verb
उत्सुवति	utsuvati	verb
उत्सृजति	utsṛjati	verb
उत्सृजते	utsṛjate	verb
उत्स्नाति	utsnāti	verb
उत्स्नायति	utsnāyati	verb
उत्स्मयति	utsmayati	verb
उदचति	udacati	verb
उदजति	udajati	verb
उदजते	udajate	verb
उदञ्चति	udañcati	verb
उदनक्ति	udanakti	verb
उदन्यति	udanyati	verb
उदर्दति	udardati	verb
उदवस्यति	udavasyati	verb
उदश्नोति	udaśnoti	verb
उदस्यति	udasyati	verb
उदाआस्ते	udāāste	verb
उदाकरोति	udākaroti	verb
उदाकुरुते	udākurute	verb
उदाजनते	udājanate	verb
उदातनोति	udātanoti	verb
उदादादति	udādādati	verb
उदाद्रवति	udādravati	verb
उदानयति	udānayati	verb
उदाप्नोति	udāpnoti	verb
उदायच्छति	udāyacchati	verb
उदायौति	udāyauti	verb
उदावहति	udāvahati	verb
उदाव्रजति	udāvrajati	verb
उदाशंसते	udāśaṃsate	verb
उदाहरति	udāharati	verb
उदिनक्षति	udinakṣati	verb
उदियर्ति	udiyarti	verb
उदीक्षते	udīkṣate	verb
उदीर्ते	udīrte	verb
उदीषति	udīṣati	verb
उदुक्षति	udukṣati	verb
उदूहति	udūhati	verb
उदूहते	udūhate	verb
उदृषति	udṛṣati	verb
उदेजति	udejati	verb
उदेति	udeti	verb
उदोषति	udoṣati	verb
उद्गच्छति	udgacchati	verb
उद्गलति	udgalati	verb
उद्गहते	udgahate	verb
उद्गायति	udgāyati	verb
उद्गिरति	udgirati	verb
उद्गुरते	udgurate	verb
उद्गृह्णाति	udgṛhṇāti	verb
उद्गृह्णीते	udgṛhṇīte	verb
उद्ग्रथयति	udgrathayati	verb
उद्ग्रथ्नाति	udgrathnāti	verb
उद्ग्रन्थति	udgranthati	verb
उद्घर्षति	udgharṣati	verb
उद्घाटयति	udghāṭayati	verb
उद्घोषति	udghoṣati	verb
उद्चष्टे	udcaṣṭe	verb
उद्जिहीते	udjihīte	verb
उद्दधाति	uddadhāti	verb
उद्दिशति	uddiśati	verb
उद्दिशते	uddiśate	verb
उद्दीप्यते	uddīpyate	verb
उद्देग्धि	uddegdhi	verb
उद्द्योतते	uddyotate	verb
उद्द्रवति	uddravati	verb
उद्धन्ति	uddhanti	verb
उद्धमति	uddhamati	verb
उद्धरति	uddharati	verb
उद्धरते	uddharate	verb
उद्धसति	uddhasati	verb
उद्धूनुते	uddhūnute	verb
उद्धूनोति	uddhūnoti	verb
उद्धृष्यति	uddhṛṣyati	verb
उद्धोषयति	uddhoṣayati	verb
उद्ध्वयति	uddhvayati	verb
उद्ध्वंसते	uddhvaṃsate	verb
उद्नयति	udnayati	verb
उद्नयते	udnayate	verb
उद्बुध्यते	udbudhyate	verb
उद्ब्रुवते	udbruvate	verb
उद्भरति	udbharati	verb
उद्भरते	udbharate	verb
उद्भवति	udbhavati	verb
उद्भासति	udbhāsati	verb
उद्भासते	udbhāsate	verb
उद्भिनत्ति	udbhinatti	verb
उद्भ्रमति	udbhramati	verb
उद्भ्राम्यति	udbhrāmyati	verb
उद्यच्छति	udyacchati	verb
उद्यच्छते	udyacchate	verb
उद्यमं करोति	udyamaṃ karoti	verb
उद्याति	udyāti	verb
उद्युङ्क्ते	udyuṅkte	verb
उद्युनक्ति	udyunakti	verb
उद्योधति	udyodhati	verb
उद्यौति	udyauti	verb
उद्रमते	udramate	verb
उद्वदति	udvadati	verb
उद्वधति	udvadhati	verb
उद्वयति	udvayati	verb
उद्वरते	udvarate	verb
उद्वरीवृजति	udvarīvṛjati	verb
उद्वर्जति	udvarjati	verb
उद्वर्णयति	udvarṇayati	verb
उद्वर्तति	udvartati	verb
उद्वर्तते	udvartate	verb
उद्वर्षते	udvarṣate	verb
उद्वसति	udvasati	verb
उद्वहति	udvahati	verb
उद्वहते	udvahate	verb
उद्वाश्यते	udvāśyate	verb
उद्विजति	udvijati	verb
उद्विजते	udvijate	verb
उद्वीक्षते	udvīkṣate	verb
उद्वृहति	udvṛhati	verb
उद्वेपते	udvepate	verb
उद्व्रजति	udvrajati	verb
उद्सृजति	udsṛjati	verb
उधर्षते	udharṣate	verb
उध्रस्नाति	udhrasnāti	verb
उध्रासयति	udhrāsayati	verb
उध्रासयते	udhrāsayate	verb
उन्नयति	unnayati	verb
उन्नयते	unnayate	verb
उन्नह्यति	unnahyati	verb
उन्निद्रयति	unnidrayati	verb
उन्मज्जति	unmajjati	verb
उन्मथयति	unmathayati	verb
उन्मथ्नाति	unmathnāti	verb
उन्मनयति	unmanayati	verb
उन्मन्दति	unmandati	verb
उन्माद्यति	unmādyati	verb
उन्मिषति	unmiṣati	verb
उन्मीयते	unmīyate	verb
उन्मीलति	unmīlati	verb
उन्मुञ्चति	unmuñcati	verb
उन्मुञ्चते	unmuñcate	verb
उन्मूर्छति	unmūrchati	verb
उन्मृजते	unmṛjate	verb
उन्मृदति	unmṛdati	verb
उन्मृष्टे	unmṛṣṭe	verb
उपकरोति	upakaroti	verb
उपकल्पते	upakalpate	verb
उपकारं करोति	upakāraṃ karoti	verb
उपकिरति	upakirati	verb
उपकुरुते	upakurute	verb
उपकृन्तति	upakṛntati	verb
उपक्रमते	upakramate	verb
उपक्रमयति	upakramayati	verb
उपक्रामति	upakrāmati	verb
उपक्रोशति	upakrośati	verb
उपक्षिपति	upakṣipati	verb
उपक्षेति	upakṣeti	verb
उपगच्छति	upagacchati	verb
उपगाति	upagāti	verb
उपगायति	upagāyati	verb
उपगाहति	upagāhati	verb
उपगूहति	upagūhati	verb
उपगूहते	upagūhate	verb
उपगृणाति	upagṛṇāti	verb
उपगृह्णाति	upagṛhṇāti	verb
उपग्रसति	upagrasati	verb
उपचरति	upacarati	verb1
उपचरति	upacarati	verb
उपचितीभवति	upacitībhavati	verb
उपचिनोति	upacinoti	verb
उपचृतति	upacṛtati	verb
उपच्छलयति	upacchalayati	verb
उपजपति	upajapati	verb
उपजहाते	upajahāte	verb
उपजानीते	upajānīte	verb
उपजायते	upajāyate	verb
उपजिघ्नते	upajighnate	verb
उपजिघ्रति	upajighrati	verb
उपजीवति	upajīvati	verb
उपजुषति	upajuṣati	verb
उपतति	upatati	verb
उपतपति	upatapati	verb
उपतृणत्ति	upatṛṇatti	verb
उपददाति	upadadāti	verb
उपदधाति	upadadhāti	verb
उपदस्यति	upadasyati	verb
उपदहति	upadahati	verb
उपदिशति	upadiśati	verb
उपदिशते	upadiśate	verb
उपदुष्यति	upaduṣyati	verb
उपद्रवति	upadravati	verb
उपधत्ते	upadhatte	verb
उपधमति	upadhamati	verb
उपधारयति	upadhārayati	verb
उपधावति	upadhāvati	verb
उपधावते	upadhāvate	verb
उपधूपयति	upadhūpayati	verb
उपनक्ति	upanakti	verb
उपनमति	upanamati	verb
उपनयति	upanayati	verb
उपनयति / -ते	upanayati / -te	verb
उपनयते	upanayate	verb
उपनाथति	upanāthati	verb
उपनिदधाति	upanidadhāti	verb
उपनिधत्ते	upanidhatte	verb
उपनिबध्नाति	upanibadhnāti	verb
उपनिमदति	upanimadati	verb
उपनिमन्त्रयति	upanimantrayati	verb
उपनिम्रेडते	upanimreḍate	verb
उपनिवृणोति	upanivṛṇoti	verb
उपनिवेष्टते	upaniveṣṭate	verb
उपनिषत्करोति	upaniṣatkaroti	verb
उपनिषीदति	upaniṣīdati	verb
उपनिहन्ति	upanihanti	verb
उपन्यस्यति	upanyasyati	verb
उपन्याचरति	upanyācarati	verb
उपन्येति	upanyeti	verb
उपपद्यति	upapadyati	verb
उपपद्यते	upapadyate	verb
उपपरीक्षते	upaparīkṣate	verb
उपपश्यति	upapaśyati	verb
उपपृङ्क्ते	upapṛṅkte	verb
उपपृच्छति	upapṛcchati	verb
उपपृणक्ति	upapṛṇakti	verb
उपप्रजायते	upaprajāyate	verb
उपप्रजिन्वति	upaprajinvati	verb
उपप्रभवति	upaprabhavati	verb
उपप्रभिनत्ति	upaprabhinatti	verb
उपप्रभूषति	upaprabhūṣati	verb
उपप्रयाति	upaprayāti	verb
उपप्रसीदति	upaprasīdati	verb
उपप्रहिणोति	upaprahiṇoti	verb
उपप्रेक्षति	upaprekṣati	verb
उपप्रेति	upapreti	verb
उपप्रेष्यति	upapreṣyati	verb
उपप्लायते	upaplāyate	verb
उपबन्धति	upabandhati	verb
उपबिभर्ति	upabibharti	verb
उपब्रूते	upabrūte	verb
उपभवति	upabhavati	verb
उपभुङ्क्ते	upabhuṅkte	verb
उपभूषति	upabhūṣati	verb
उपभ्रमति	upabhramati	verb
उपमज्जति	upamajjati	verb
उपमज्जते	upamajjate	verb
उपमन्त्रयति	upamantrayati	verb
उपमन्त्रयते	upamantrayate	verb
उपमन्थति	upamanthati	verb
उपमार्ष्टि	upamārṣṭi	verb
उपमृद्नाति	upamṛdnāti	verb
उपयच्छति	upayacchati	verb
उपयच्छते	upayacchate	verb
उपयतते	upayatate	verb
उपयाति	upayāti	verb
उपयुङ्क्ते	upayuṅkte	verb
उपरमति	uparamati	verb
उपरमते	uparamate	verb
उपरुणद्धि	uparuṇaddhi	verb
उपरुन्द्धे	uparunddhe	verb
उपरुन्धति	uparundhati	verb
उपरुन्धते	uparundhate	verb
उपर्जति	uparjati	verb
उपलक्षयति	upalakṣayati	verb
उपलक्षयते	upalakṣayate	verb
उपलभते	upalabhate	verb
उपलभ्यते	upalabhyate	verb
उपलिखति	upalikhati	verb
उपलिम्पति	upalimpati	verb
उपवति	upavati	verb
उपवदति	upavadati	verb
उपवदते	upavadate	verb
उपवधति	upavadhati	verb
उपवनति	upavanati	verb
उपवपति	upavapati	verb
उपवर्णयति	upavarṇayati	verb
उपवल्हति	upavalhati	verb
उपवल्हते	upavalhate	verb
उपवसति	upavasati	verb
उपवहति	upavahati	verb
उपवाजयति	upavājayati	verb
उपविशति	upaviśati	verb
उपवीजति	upavījati	verb
उपवेति	upaveti	verb
उपशक्नोति	upaśaknoti	verb
उपशङ्कते	upaśaṅkate	verb
उपशाम्यति	upaśāmyati	verb
उपशाम्यते	upaśāmyate	verb
उपशिक्षति	upaśikṣati	verb
उपशिक्षते	upaśikṣate	verb
उपशिङ्घति	upaśiṅghati	verb
उपशृणोति	upaśṛṇoti	verb
उपश्च्योतति	upaścyotati	verb
उपश्नाति	upaśnāti	verb
उपश्नुते	upaśnute	verb
उपश्नोति	upaśnoti	verb
उपश्रयते	upaśrayate	verb
उपश्राम्यति	upaśrāmyati	verb
उपश्लोकयति	upaślokayati	verb
उपसङ्गच्छते	upasaṅgacchate	verb
उपसचते	upasacate	verb
उपसन्तनोति	upasantanoti	verb
उपसन्दधाति	upasandadhāti	verb
उपसन्धत्ते	upasandhatte	verb
उपसमाकरोति	upasamākaroti	verb
उपसमादधाति	upasamādadhāti	verb
उपसमिन्द्धे	upasaminddhe	verb
उपसम्पद्यते	upasampadyate	verb
उपसम्भिनत्ति	upasambhinatti	verb
उपसरति	upasarati	verb
उपसर्गयति	upasargayati	verb
उपसर्पति	upasarpati	verb
उपसर्पते	upasarpate	verb
उपसान्त्वयति	upasāntvayati	verb
उपसिञ्चति	upasiñcati	verb
उपसीदति	upasīdati	verb
उपसृजति	upasṛjati	verb
उपसृजते	upasṛjate	verb
उपसेवते	upasevate	verb
उपसंनुदति	upasaṃnudati	verb
उपसंरोधति	upasaṃrodhati	verb
उपसंरोहति	upasaṃrohati	verb
उपसंश्रयति	upasaṃśrayati	verb
उपसंश्रयते	upasaṃśrayate	verb
उपसंहरण	upasaṃharaṇa	vb.
उपसंहरति	upasaṃharati	verb
उपसंहरते	upasaṃharate	verb
उपस्तिष्ठति	upastiṣṭhati	verb
उपस्तिष्ठते	upastiṣṭhate	verb
उपस्तृणाति	upastṛṇāti	verb
उपस्तृणीते	upastṛṇīte	verb
उपस्तौति	upastauti	verb
उपस्पृशति	upaspṛśati	verb
उपस्मरति	upasmarati	verb
उपहन्ति	upahanti	verb
उपहरति	upaharati	verb
उपहरते	upaharate	verb
उपहसति	upahasati	verb
उपहासयति	upahāsayati	verb
उपहिंसति	upahiṃsati	verb
उपहिंसते	upahiṃsate	verb
उपह्वयते	upahvayate	verb
उपह्वरते	upahvarate	verb
उपाकरोति	upākaroti	verb
उपाकुरुते	upākurute	verb
उपाख्याति	upākhyāti	verb
उपाजिघ्रति	upājighrati	verb
उपादत्ते	upādatte	verb
उपादधाति	upādadhāti	verb
उपादिशति	upādiśati	verb
उपाधत्ते	upādhatte	verb
उपानयति	upānayati	verb
उपानयति / -ते	upānayati / -te	verb
उपानयते	upānayate	verb
उपाप्नोति	upāpnoti	verb
उपायाति	upāyāti	verb
उपारमति	upāramati	verb
उपारमते	upāramate	verb
उपारुदति	upārudati	verb
उपार्च्छति	upārcchati	verb
उपार्षति	upārṣati	verb
उपालभते	upālabhate	verb
उपावर्तति	upāvartati	verb
उपावर्तते	upāvartate	verb
उपावश्रयते	upāvaśrayate	verb
उपावैति	upāvaiti	verb
उपाव्रजति	upāvrajati	verb
उपाश्रयति	upāśrayati	verb
उपासृजति	upāsṛjati	verb
उपास्ति	upāsti	verb
उपास्तिष्ठते	upāstiṣṭhate	verb
उपास्ते	upāste	verb
उपाहरति	upāharati	verb
उपाहरते	upāharate	verb
उपाहिण्डते	upāhiṇḍate	verb
उपाह्वयते	upāhvayate	verb
उपेक्षते	upekṣate	verb
उपेति	upeti	verb
उपेष्णोति	upeṣṇoti	verb
उपोदाहरति	upodāharati	verb
उपोदुनत्ति	upodunatti	verb
उपोद्बलयति	upodbalayati	verb
उपोद्यच्छति	upodyacchati	verb
उपोपपरामृशति	upopaparāmṛśati	verb
उपोषति	upoṣati	verb
उपोहति	upohati	verb
उप्लवति	uplavati	verb
उप्लवते	uplavate	verb
उब्जति	ubjati	verb
उभ्नाति	ubhnāti	verb
उररी करोति	urarī karoti	verb
उरी करोति	urī karoti	verb
उल्लसति	ullasati	verb
उल्लसते	ullasate	verb
उल्लाघयति	ullāghayati	verb
उल्लापयते	ullāpayate	verb
उल्लिखति	ullikhati	verb
उल्लुठति	ulluṭhati	verb
उष्यताम्	uṣyatām	verb
उष्यते	uṣyate	verb
ऊनयति	ūnayati	verb
ऊनी करोति	ūnī karoti	verb
ऊनीभवति	ūnībhavati	verb
ऊरि करोति	ūri karoti	verb
ऊर्जयते	ūrjayate	verb
ऊर्णोति	ūrṇoti	verb
ऊर्णौति	ūrṇauti	verb
ऊर्ध्वायते	ūrdhvāyate	verb
ऊर्ध्वी करोति	ūrdhvī karoti	verb
ऊर्ध्वं गच्छति	ūrdhvaṃ gacchati	verb
ऊषति	ūṣati	verb
ऊषरायते	ūṣarāyate	verb
ऊष्मायते	ūṣmāyate	verb
ऊहति	ūhati	verb
ऊहते	ūhate	verb
ऋघायति	ṛghāyati	verb
ऋघायते	ṛghāyate	verb
ऋच्छति	ṛcchati	verb
ऋणं ददाति	ṛṇaṃ dadāti	verb
ऋतीयते	ṛtīyate	verb
ऋभुक्षीणति	ṛbhukṣīṇati	verb
एकचित्तीभवति	ekacittībhavati	verb
एकपक्षीभवति	ekapakṣībhavati	verb
एकायनीभवति	ekāyanībhavati	verb
एकी करोति	ekī karoti	verb
एकीभवति	ekībhavati	verb
एजति	ejati	verb
एठते	eṭhate	verb
एधते	edhate	verb
एलायति	elāyati	verb
एषति	eṣati	verb
एषते	eṣate	verb
एषिष्यति	eṣiṣyati	future
ओखति	okhati	verb
ओलति	olati	verb
ओषति	oṣati	verb
ओषनीय	oṣanīya	verb
ओषितव्य	oṣitavya	verb
ओषिष्यति	oṣiṣyati	verb
ओषेत्	oṣet	verb
ओष्यते	oṣyate	verb
ओहति	ohati	verb
और्वायते	aurvāyate	verb
औषधी करोति	auṣadhī karoti	verb
औष्णीय	auṣṇīya	verb
कक्षी करोति	kakṣī karoti	verb
कखति	kakhati	verb
कचति	kacati	verb
कजति	kajati	verb
कञ्चते	kañcate	verb
कटकटापयति	kaṭakaṭāpayati	verb
कटति	kaṭati	verb
कटाक्षयति	kaṭākṣayati	verb
कठोरयति	kaṭhorayati	verb
कणति	kaṇati	verb
कण्ठति	kaṇṭhati	verb
कण्ठते	kaṇṭhate	verb
कण्ठयति	kaṇṭhayati	verb
कण्डी करोति	kaṇḍī karoti	verb
कण्डूयति	kaṇḍūyati	verb
कण्डूयते	kaṇḍūyate	verb
कण्डूयनं करोति	kaṇḍūyanaṃ karoti	verb
कण्डूयियिषति	kaṇḍūyiyiṣati	verb
कण्वायते	kaṇvāyate	verb
कत्थते	katthate	verb
कत्रयति	katrayati	verb
कथयति	kathayati	verb
कथयिष्यति	kathayiṣyati	future
कथापयति	kathāpayati	verb
कथायोगं त्यजति	kathāyogaṃ tyajati	verb
कथावशेषीभवति	kathāvaśeṣībhavati	verb
कदते	kadate	verb
कदम्बकी करोति	kadambakī karoti	verb
कदर्थयति	kadarthayati	verb
कदर्थी करोति	kadarthī karoti	verb
कनयति	kanayati	verb
कन्दति	kandati	verb
कन्दलयति	kandalayati	verb
कन्दुकायते	kandukāyate	verb
कन्याम् ददाति	kanyām dadāti	verb
कपिलायते	kapilāyate	verb
कपिली करोति	kapilī karoti	verb
कपिशी करोति	kapiśī karoti	verb
कफोणिगुडायते	kaphoṇiguḍāyate	verb
कबते	kabate	verb
कमलबालनालयते	kamalabālanālayate	verb
कम्पते	kampate	verb
कम्पनं करोति	kampanaṃ karoti	verb
कम्पन्ते	kampante	verb
कम्पिष्यते	kampiṣyate	verb
कम्पिष्यते	kampiṣyate	future
करदी करोति	karadī karoti	verb
करवानि	karavāni	verb
करी करोति	karī karoti	verb
करुणायति	karuṇāyati	verb
करुणायते	karuṇāyate	verb
करोमि	karoti	verb
कर्कशशब्देनाप्रसादं सूचयति	karkaśaśabdenāprasādaṃ sūcayati	verb
कर्जति	karjati	verb
कर्णपूरी करोति	karṇapūrī karoti	verb
कर्णयति	karṇayati	verb
कर्णावतंसी करोति	karṇāvataṃsī karoti	verb
कर्तति	kartati	verb
कर्तनं करोति	kartanaṃ karoti	verb
कर्तयति	kartayati	verb
कर्तयिष्यति	kartayiṣyati	future
कर्त्रीयति	kartrīyati	verb
कर्वति	karvati	verb
कर्षति	karṣati	verb
कर्षते	karṣate	verb
कर्षनं करोति	karṣanaṃ karoti	verb
कलङ्कयति	kalaṅkayati	verb
कलते	kalate	verb
कलयति	kalayati	verb
कलहायते	kalahāyate	verb
कलुषयति	kaluṣayati	verb
कलुषी करोति	kaluṣī karoti	verb
कल्की करोति	kalkī karoti	verb
कल्की भवति	kalkī bhavati	verb
कल्पते	kalpate	verb
कल्पशतायते	kalpaśatāyate	verb
कल्लते	kallate	verb
कव करोति	kava karoti	verb
कवते	kavate	verb
कवलयति	kavalayati	verb
कवली करोति	kavalī karoti	verb
कशति	kaśati	verb
कषायी करोति	kaṣāyī karoti	verb
कष्टायते	kaṣṭāyate	verb
कसति	kasati	verb
काङ्क्षति	kāṅkṣati	verb
काङ्क्षते	kāṅkṣate	verb
काञ्चते	kāñcate	verb
काणयति	kāṇayati	verb
कात् करोति	kāt karoti	verb
कान्दिशी करोति	kāndiśī karoti	verb
कामकारं करोति	kāmakāraṃ karoti	verb
काम्यति	kāmyati	verb
कारयति / -ते	kārayati / -te	verb
कालयति	kālayati	verb
कालं करोति	kālaṃ karoti	verb
कावयति / -ते	kāvayati / -te	verb
काशते	kāśate	verb
काशिष्यते	kāśiṣyate	future
काश्यते	kāśyate	verb
काष्ठी भवति	kāṣṭhī bhavati	verb
कांसते	kāṃsate	verb
किकिरा करोति	kikirā karoti	verb
किम्पुरुषीकृ	kimpuruṣīkṛ	verb
किरति	kirati	verb
किलकिलायति	kilakilāyati	verb
किलकिलायते	kilakilāyate	verb
किलति	kilati	verb
किष्कयते	kiṣkayate	verb
कीटयति	kīṭayati	verb
कीर्तनं करोति	kīrtanaṃ karoti	verb
कीर्तयति	kīrtayati	verb
कुक्षिगती करोति	kukṣigatī karoti	verb
कुञ्चति	kuñcati	verb
कुञ्जति	kuñjati	verb
कुटति	kuṭati	verb
कुटिली करोति	kuṭilī karoti	verb
कुडति	kuḍati	verb
कुण्ठति	kuṇṭhati	verb
कुण्डति	kuṇḍati	verb
कुत्सयति	kutsayati	verb
कुन्थति	kunthati	verb
कुप्यति	kupyati	verb
कुप्यते	kupyate	verb
कुरुथ	kurutha	verb
कुरुथः	kuruthaḥ	verb
कुर्मः	kurmaḥ	verb
कुर्वन्ति	kurvanti	verb
कुशली करोति	kuśalī karoti	verb
कुश्यति	kuśyati	verb
कुषुभ्यति	kuṣubhyati	verb
कुष्णाति	kuṣṇāti	verb
कुसुमयति	kusumayati	verb
कुस्मयते	kusmayate	verb
कुहयते	kuhayate	verb
कुहुकुहायते	kuhukuhāyate	verb
कूजति	kūjati	verb
कूटयति	kūṭayati	verb
कूटयते	kūṭayate	verb
कूडति	kūḍati	verb
कूडयति	kūḍayati	verb
कूपयति	kūpayati	verb
कूर्दति	kūrdati	verb
कूर्दते	kūrdate	verb
कूर्दनं करोति	kūrdanaṃ karoti	verb
कूलति	kūlati	verb
कृच्छ्रायते	kṛcchrāyate	verb
कृच्छ्री भवति	kṛcchrī bhavati	verb
कृणत्ति	kṛṇatti	verb
कृण्वति	kṛṇvati	verb
कृतयति	kṛtayati	verb
कृतार्थी करोति	kṛtārthī karoti	verb
कृतार्थी भवति	kṛtārthī bhavati	verb
कृन्तते	kṛntate	verb
कृपण	kṛpaṇa	verb
कृपणायते	kṛpaṇāyate	verb
कृपयति	kṛpayati	verb
कृपायते	kṛpāyate	verb
कृशी करोति	kṛśī karoti	verb
कृशी भवति	kṛśī bhavati	verb
कृश्यति	kṛśyati	verb
कृषति	kṛṣati	verb
कृषते	kṛṣate	verb
कृष्टमती करोति	kṛṣṭamatī karoti	verb
केतयति	ketayati	verb
केन्द्रीकरोति	kendrīkaroti	verb
केलति	kelati	verb
कोकते	kokate	verb
कोचति	kocati	verb
कोजति	kojati	verb
कोपयति	kopayati	verb
कोपयते	kopayate	verb
कोपायते	kopāyate	verb
कोलाहलं करोति	kolāhalaṃ karoti	verb
कोष्ठी करोति	koṣṭhī karoti	verb
क्नस्यति	knasyati	verb
क्नूयते	knūyate	verb
क्रन्दति	krandati	verb
क्रन्दते	krandate	verb
क्रन्दनं करोति	krandanaṃ karoti	verb
क्रमते	kramate	verb
क्रामति	krāmati	verb
क्रीडति	krīḍati	verb
क्रीणाति	krīṇāti	verb
क्रीणीते	krīṇīte	verb
क्रुञ्चति	kruñcati	verb
क्रुडति	kruḍati	verb
क्रूरी करोति	krūrī karoti	verb
क्रेष्यति	kreṣyati	verb
क्रोञ्चति	kroñcati	verb
क्रोडी करोति	kroḍī karoti	verb
क्रंशति	kraṃśati	verb
क्लथति	klathati	verb
क्लन्दति	klandati	verb
क्लन्दते	klandate	verb
क्लामति	klāmati	verb
क्लाम्यति	klāmyati	verb
क्लिक् करोति	klik karoti	verb
क्लिन्दति	klindati	verb
क्लिन्दते	klindate	verb
क्लिबते	klibate	verb
क्लिश्नाति	kliśnāti	verb
क्लिश्यते	kliśyate	verb
क्लेदयति	kledayati	verb
क्लेशते	kleśate	verb
क्वथते	kvathate	verb
क्षणङ्करोति	kṣaṇaṅkaroti	verb
क्षदते	kṣadate	verb
क्षमते	kṣamate	verb
क्षरति	kṣarati	verb
क्षामी करोति	kṣāmī karoti	verb
क्षायति	kṣāyati	verb
क्षालनं करोति	kṣālanṃ karoti	verb
क्षालयति	kṣālayati	verb
क्षिपति	kṣipati	verb
क्षिपते	kṣipate	verb
क्षीजति	kṣījati	verb
क्षीबति	kṣībati	verb
क्षीव्यति	kṣīvyati	verb
क्षुध्यति	kṣudhyati	verb
क्षुरति	kṣurati	verb
क्षेत्री करोति	kṣetrī karoti	verb
क्षेत्रीयति	kṣetrīyati	verb
क्षेपनं करोति	kṣepanaṃ karoti	verb
क्षेपायते	kṣepāyate	verb
क्षेवति	kṣevati	verb
क्ष्मायते	kṣmāyate	verb
क्ष्मीलति	kṣmīlati	verb
क्ष्विद्यति	kṣvidyati	verb
क्ष्वेडति	kṣveḍati	verb
क्ष्वेडते	kṣveḍate	verb
क्ष्वेदते	kṣvedate	verb
क्ष्वेलति	kṣvelati	verb
खचति	khacati	verb
खञ्जति	khañjati	verb
खट्टयति	khaṭṭayati	verb
खट्वीयति	khaṭvīyati	verb
खणखणायते	khaṇakhaṇāyate	verb
खण्डशः करोति	khaṇḍaśaḥ karoti	verb
खदति	khadati	verb
खनति	khanati	verb
खरी भवति	kharī bhavati	verb
खर्जति	kharjati	verb
खर्दति	khardati	verb
खलति	khalati	verb
खली करोति	khalī karoti	verb
खल्लते	khallate	verb
खषति	khaṣati	verb
खाडयति	khāḍayati	verb
खिली करोति	khilī karoti	verb
खुण्डते	khuṇḍate	verb
खुदति	khudati	verb
खुरति	khurati	verb
खुरुखुरायते	khurukhurāyate	verb
खेटति	kheṭati	verb
खेलति	khelati	verb
खोरति	khorati	verb
ख्याति	khyāti	verb
ख्रीष्टीयं करोति	khrīṣṭīyaṃ karoti	verb
गङ्गूयति	gaṅgūyati	verb
गच्छामि	gacchāmi	verb
गजति	gajati	verb
गणनां करोति	gaṇanāṃ karoti	verb
गणयति	gaṇayati	verb
गण्डूषयति	gaṇḍūṣayati	verb
गतागतं करोति	gatāgataṃ karoti	verb
गदति	gadati	verb
गदायते	gadāyate	verb
गन्धयते	gandhayate	verb
गर्जति	garjati	verb
गर्जनं करोति	garjanaṃ karoti	verb
गर्दति	gardati	verb
गर्भम् उपलभते	garbham upalabhate	verb
गर्वयति	garvayati	verb
गलति	galati	verb
गलयते	galayate	verb
गवते	gavate	verb
गवेषते	gaveṣate	verb
गवेषयति	gaveṣayati	verb
गवेषयते	gaveṣayate	verb
गव्यति	gavyati	verb
गहनायते	gahanāyate	verb
गहयति	gahayati	verb
गाधते	gādhate	verb
गालोडयते	gāloḍayate	verb
गाहते	gāhate	verb
गिरति	girati	verb
गिरते	girate	verb
गिलति	gilati	verb
गुञ्जति	guñjati	verb
गुडति	guḍati	verb
गुणयति	guṇayati	verb
गुण्ठयति	guṇṭhayati	verb
गुप्यति	gupyati	verb
गुरू करोति	gurū karoti	verb
गुवति	guvati	verb
गूहति	gūhati	verb
गूहते	gūhate	verb
गृणाति	gṛṇāti	verb
गृणीते	gṛṇīte	verb
गृध्यति	gṛdhyati	verb
गृहयते	gṛhayate	verb
गृहायते	gṛhāyate	verb
गृह्णाति	gṛhṇāti	verb
गेपते	gepate	verb
गेषते	geṣate	verb
गोपयति	gopayati	verb
गोपयति / गोपयते	gopayati / gopayate	verb
गोपयते	gopayate	verb
गोपायति	gopāyati	verb
गोमतति	gomatati	verb
गोमत्यते	gomatyate	verb
गोमयति	gomayati	verb
ग्रथति / -ते	grathati / -te	verb
ग्रथ्नाति	grathnāti	verb
ग्रन्थिली भवति	granthilī bhavati	verb
ग्रन्थी भवति	granthī bhavati	verb
ग्रसति	grasati	verb
ग्रसते	grasate	verb
ग्रामयति	grāmayati	verb
ग्रासपात्रीकरोति	grāsapātrīkaroti	verb
ग्रासी करोति	grāsī karoti	verb
ग्रोचति	grocati	verb
ग्लहते	glahate	verb
ग्लायति	glāyati	verb
ग्लेपते	glepate	verb
ग्लेषते	gleṣate	verb
ग्लोचति	glocati	verb
घग्घति	ghagghati	verb
घटते	ghaṭate	verb
घनायते	ghanāyate	verb
घनी करोति	ghanī karoti	verb
घनीभवति	ghanībhavati	verb
घरति	gharati	verb
घर्णुते	gharṇute	verb
घर्णोति	gharṇoti	verb
घर्षति	gharṣati	verb
घिण्णते	ghiṇṇate	verb
घुटति	ghuṭati	verb
घुडति	ghuḍati	verb
घुरघुरायते	ghuraghurāyate	verb
घुरति	ghurati	verb
घुर्घुरायते	ghurghurāyate	verb
घूर्णति	ghūrṇati	verb
घूर्णते	ghūrṇate	verb
घूर्यते	ghūryate	verb
घृणुते	ghṛṇute	verb
घृणोति	ghṛṇoti	verb
घोषति	ghoṣati	verb
घोषते	ghoṣate	verb
ङवते	ṅavate	verb
चकति	cakati	verb
चकते	cakate	verb
चकम्पे	cakampe	verb
चकार	cakāra	Perfect
चकास्ति	cakāsti	verb
चके	cake	verb
चक्कयति	cakkayati	verb
चचार	cacāra	Perfect
चञ्चति	cañcati	verb
चटुलयति	caṭulayati	verb
चटुलयते	caṭulayate	verb
चणति	caṇati	verb
चण्डकरायते	caṇḍakarāyate	verb
चतुरश्री करोति	caturaśrī karoti	verb
चनसयति	canasayati	verb
चनस्यति	canasyati	verb
चन्दनायते	candanāyate	verb
चपलयति	capalayati	verb
चमत् करोति	camat karoti	verb
चयनं करोति	cayanaṃ karoti	verb
चरति	carati	verb
चरसि	carasi	verb
चरितार्थयति	caritārthayati	verb
चर्चयति	carcayati	verb
चर्चायते	carcāyate	verb
चर्तति	cartati	verb1
चर्वणं करोति	carvaṇaṃ karoti	verb
चलति	calati	verb
चलितुम्	calitum	verb
चली करोति	calī karoti	verb
चष्टे	caṣṭe	verb
चालयति	cālayati	verb
चिकित्सा करोति	cikitsā karoti	verb
चिकेति	ciketi	verb
चिटिचिटायते	ciṭiciṭāyate	verb
चित्रणम् करोति	citraṇam karoti	verb
चित्रयति	citrayati	verb
चित्रीयते	citrīyate	verb
चित्रं करोति	citraṃ karoti	verb
चिनुते	cinute	verb
चिनोति	cinoti	verb
चिन्तयति	cintayati	verb
चिमिचिमायते	cimicimāyate	verb
चिरयति	cirayati	verb
चिह्नयति	cihnayati	verb
चीवरयते	cīvarayate	verb
चुक्षावयिषति	cukṣāvayiṣati	verb
चुक्षूषति	cukṣūṣati	verb
चुरण्यति	curaṇyati	verb
चूडयति	cūḍayati	verb
चूर्णी भवति	cūrṇī bhavati	verb
चूषति	cūṣati	verb
चेतति	cetati	verb
चोदति	codati	verb
छदति	chadati	verb
छन्दयति	chandayati	verb
छर्दति	chardati	verb
छर्दयते	chardayate	verb
छिद्रं करोति	chidraṃ karoti	verb
छिन्नमस्तकी करोति	chinnamastakī karoti	verb
छृन्त्ते	chṛntte	verb
छेदनं करोति	chedanaṃ karoti	verb
जगाम	jagāma	Perfect
जज्वलुः	jajvaluḥ	Perfect
जञ्जभीति	jañjabhīti	verb
जञ्जभ्यते	jañjabhyate	verb
जटिलयति	jaṭilayati	verb
जटिली Kअरोति	jaṭilī Karoti	verb
जडयते	jaḍayate	verb
जडी करोति	jaḍī karoti	verb
जडीभवति	jaḍībhavati	verb
जनति	janati	verb
जम्भति	jambhati	verb
जयति	jayati	verb1
जयति	jayati	verb
जल्पति	jalpati	verb
जल्पनं करोति	jalpanaṃ karoti	verb
जसति	jasati	verb
जसते	jasate	verb
जहाति	jahāti	verb
जानाति	jānāti	verb
जानिते	jānite	verb
जायते	jāyate	verb
जारयति	jārayati	verb
जिगाति	jigāti	verb
जिघरति	jigharati	verb
जिघर्ति	jigharti	verb
जिन्वति	jinvati	verb
जिहीते	jihīte	verb
जिह्मायति	jihmāyati	verb
जिह्मायते	jihmāyate	verb
जिह्मी भवति	jihmī bhavati	verb
जिह्रेति	jihreti	verb
जीर्णम् भवति	jīrṇam bhavati	verb
जीवति	jīvati	verb
जीविका करोति	jīvikā karoti	verb
जीवितं धारयति	jīvitaṃ dhārayati	verb
जुहोति	juhoti	verb
जेगीयते	jegīyate	verb
जेहते	jehate	verb
जंहति	jaṃhati	verb
ज्यवते	jyavate	verb
ज्योक् करोति	jyok karoti	verb
ज्रयति	jrayati	verb
ज्राययति	jrāyayati	verb
ज्रिणाति	jriṇāti	verb
ज्रिम्भते	jrimbhate	verb
ज्वलति	jvalati	verb
झगझगायते	jhagajhagāyate	verb
झणझणायते	jhaṇajhaṇāyate	verb
टिकते	ṭikate	verb
टौकते	ṭaukate	verb
डापयते	ḍāpayate	verb
डीयते	ḍīyate	verb
तक्षति	takṣati	verb
तङ्गति	taṅgati	verb
तटति	taṭati	verb
तटायते	taṭāyate	verb
तण्डते	taṇḍate	verb
तनुते	tanute	verb
तनू करोति	tanū karoti	verb
तनोति	tanoti	verb
तन्त्रयते	tantrayate	verb
तन्दते	tandate	verb
तन्द्रति	tandrati	verb
तरति	tarati	verb
तरुणी भवति	taruṇī bhavati	verb
तरुते	tarute	verb
तर्जति	tarjati	verb
तर्जनं करोति	tarjanaṃ karoti	verb
तर्जयति	tarjayati	verb
तविषीयते	taviṣīyate	verb
ताडङ्की करोति	tāḍaṅkī karoti	verb
ताडनं करोति	tāḍanaṃ karoti	verb
ताडयति	tāḍayati	verb
ताम्री करोति	tāmrī karoti	verb
तारयति	tārayati	verb
तितर्ति	titarti	verb
तिमिरयति	timirayati	verb
तिमिरयते	timirayate	verb
तिरयति	tirayati	verb
तिरस्करोति	tiraskaroti	verb
तिरस्यति	tirasyati	verb
तिरोदधाति	tirodadhāti	verb
तिरोधत्ते	tirodhatte	verb
तिरो भवति	tiro bhavati	verb
तिलकयति	tilakayati	verb
तिल्विलायते	tilvilāyate	verb
तीरयति	tīrayati	verb
तीव्रयति	tīvrayati	verb
तीव्री करोति	tīvrī karoti	verb
तीव्री भवति	tīvrī bhavati	verb
तुणति	tuṇati	verb
तुदति	tudati	verb
तुदते	tudate	verb
तुरण्यति	turaṇyati	verb
तुरीयति	turīyati	verb
तुर्वति	turvati	verb
तुलयति / -ते	tulayati / -te	verb
तुष्यति	tuṣyati	verb
तूर्वति	tūrvati	verb
तृणयति	tṛṇayati	verb
तृप्ती करोति	tṛptī karoti	verb
तेपति	tepati	verb
तोडते	toḍate	verb
तोलति / -ते	tolati / -te	verb
तोलयति	tolayati	verb
तोलयिष्यते	tolayiṣyate	verb
तोसति	tosati	verb
त्यग्व्यधनम् करोति	tyagvyadhanam karoti	verb
त्यजति	tyajati	verb
त्यागं करोति	tyāgaṃ karoti	verb
त्रसति	trasati	verb
त्रस्यति	trasyati	verb
त्रासयति	trāsayati	verb
त्रिधा करोति	tridhā karoti	verb
त्रिशूलायति	triśūlāyati	verb
त्वक्षति	tvakṣati	verb
त्वङ्गति	tvaṅgati	verb
त्वचति	tvacati	verb
त्वेषति	tveṣati	verb
त्वेषते	tveṣate	verb
थरथरायति	tharatharāyati	verb
दक्षति	dakṣati	verb
दक्षते	dakṣate	verb
दक्षिणाम् आदिशति	dakṣiṇām ādiśati	verb
दण्डयति	daṇḍayati	verb
ददाति	dadāti	verb
ददामि	dadāmi	verb
ददृशुः	dadṛshuḥ	verb
ददृशे	dadṛśe	verb
दधाति	dadhāti	verb
दधाते	dadhāte	verb
दमनं करोति	damanaṃ karoti	verb
दमन्यति	damanyati	verb
दमायति	damāyati	verb
दम्भोलिपातायते	dambholipātāyate	verb
दयते	dayate	verb
दरति	darati	verb
दरयति	darayati	verb
दर्शनं करोति	darśanaṃ karoti	verb
दवति	davati	verb
दशति	daśati	verb
दशस्यति	daśasyati	verb
दस्मत् करोति	dasmat karoti	verb
दस्युसाद् भवति	dasyusād bhavati	verb
दानप्रति भवति	dānaprati bhavati	verb
दानवशी करोति	dānavaśī karoti	verb
दाम्यति	dāmyati	verb
दायति	dāyati	verb
दायाद्येन प्राप्नोति	dāyādyena prāpnoti	verb
दारयति / -ते	dārayati / -te	verb
दारयति	dārayati	verb
दारयते	dārayate	verb
दारुणायते	dāruṇāyate	verb
दावदहनज्वालाकलापयते	dāvadahanajvālākalāpayate	verb
दासी करोति	dāsī karoti	verb
दासी भवति	dāsī bhavati	verb
दिदेष्टि	dideṣṭi	verb
दिधीते	didhīte	verb
दिधेष्टि	didheṣṭi	verb
दिनी करोति	dinī karoti	verb
दिन्वति	dinvati	verb
दिम्पयते	dimpayate	verb
दिवसी करोति	divasī karoti	verb
दिव्यति	divyati	verb
दीक्षते	dīkṣate	verb
दीद्यति	dīdyati	verb
दीधीते	dīdhīte	verb
दीप्यते	dīpyate	verb
दीयति	dīyati	verb
दीयते	dīyate	verb
दीर्घी करोति	dīrghī karoti	verb
दीर्घी भवति	dīrghī bhavati	verb
दीर्यति	dīryati	verb
दीर्यते	dīryate	verb
दुग्धे	dugdhe	verb
दुच्छुनायते	ducchunāyate	verb
दुधुवे	dudhuve	verb
दुनोति	dunoti	verb
दुर्दर्शतायते	durdarśatāyate	verb
दुर्बली भवति	durbalī bhavati	verb
दुर्हणायति	durhaṇāyati	verb
दुवस् करोति	duvas karoti	verb
दुवस्यति	duvasyati	verb
दुष्टीयति	duṣṭīyati	verb
दुष्यति	duṣyati	verb
दुहे	duhe	verb
दुःखाकरोति	duḥkhākaroti	verb
दुःखा करोति	duḥkhā karoti	verb
दूरी करोति	dūrī karoti	verb
दूरी भवति	dūrī bhavati	verb
दूर्वति	dūrvati	verb
दूषयति	dūṣayati	verb
दृढतरी करोति	dṛḍhatarī karoti	verb
दृढीकरोति	dṛḍhīkaroti	verb
दृढी करोति	dṛḍhī karoti	verb
दृणाति	dṛṇāti	verb
दृप्यति	dṛpyati	verb
दृफति	dṛphati	verb
दृम्फति	dṛmphati	verb
दृश्यते	dṛśyate	verb
दृष्टान्तयति	dṛṣṭāntayati	verb
देवयति	devayati	verb
दोग्धि	dogdhi	verb
दोलायते	dolāyate	verb
दोषायते	doṣāyate	verb
दोहति	dohati	verb
दंशति	daṃśati	verb
दंशनं करोति	daṃśanaṃ karoti	verb
द्यति	dyati	verb
द्यायति	dyāyati	verb
द्यौति	dyauti	verb
द्रढयति	draḍhayati	verb
द्रमति	dramati	verb
द्रवति	dravati	verb
द्रवते	dravate	verb
द्रवस्यति	dravasyati	verb
द्रवी करोति	dravī karoti	verb
द्रवी भवति	dravī bhavati	verb
द्राखति	drākhati	verb
द्राघते	drāghate	verb
द्राङ्क्षति	drāṅkṣati	verb
द्राडते	drāḍate	verb
द्राति	drāti	verb
द्रियते	driyate	verb
द्रीकरोति	drīkaroti	verb
द्रुणति	druṇati	verb
द्रुणोति	druṇoti	verb
द्रुमायते	drumāyate	verb
द्रुह्यति	druhyati	verb
द्रूणाति	drūṇāti	verb
द्रूणोति	drūṇoti	verb
द्वन्द्वी भवति	dvandvī bhavati	verb
द्वरति	dvarati	verb
द्वारी करोति	dvārī karoti	verb
द्विगुणति	dviguṇati	verb
द्विगुणयति	dviguṇayati	verb
द्विगुणी करोति	dviguṇī karoti	verb
द्विगुणी भवति	dviguṇī bhavati	verb
द्विजाति करोति	dvijāti karoti	verb
द्विजी भवति	dvijī bhavati	verb
द्विधा करोति	dvidhā karoti	verb
द्विवृन्तायते	dvivṛntāyate	verb
द्वेक्ष्यति	dvekṣyati	verb
द्वैधी भवति	dvaidhī bhavati	verb
धक्कयति	dhakkayati	verb
धनदायते	dhanadāyate	verb
धयति	dhayati	verb
धरति	dharati	verb
धर्भाधिकारे नियुनक्ति	dharbhādhikāre niyunakti	verb
धर्षति	dharṣati	verb
धर्षयति	dharṣayati	verb
धवलय	dhavalaya	verb
धवलयति	dhavalayati	verb
धवलायते	dhavalāyate	verb
धायति	dhāyati	verb
धावति	dhāvati	verb
धावते	dhāvate	verb
धावनं करोति	dhāvanaṃ karoti	verb
धिक् करोति	dhik karoti	verb
धिक्षते	dhikṣate	verb
धियायते	dhiyāyate	verb
धीयते	dhīyate	verb
धुक्षते	dhukṣate	verb
धुनयति	dhunayati	verb
धूनयति	dhūnayati	verb
धूमायति	dhūmāyati	verb
धूमायते	dhūmāyate	verb
धूम्रयति	dhūmrayati	verb
धूम्री करोति	dhūmrī karoti	verb
धृष्णोति	dhṛṣṇoti	verb
धोरति	dhorati	verb
ध्यामली करोति	dhyāmalī karoti	verb
ध्यायति	dhyāyati	verb
ध्वजी करोति	dhvajī karoti	verb
ध्वनति	dhvanati	verb
ध्वरति	dhvarati	verb
नक्षति	nakṣati	verb
नक्षते	nakṣate	verb
नखति	nakhati	verb
नगरायते	nagarāyate	verb
नङ्खति	naṅkhati	verb
नटति	naṭati	verb
नदति	nadati	verb
ननाद	nanāda	Perfect
नन्दति	nandati	verb
नन्दते	nandate	verb
न पृच्छति	na pṛcchati	verb
नमति	namati	verb
नमते	namate	verb
नमयति	namayati	verb
नमस्करोति	namaskaroti	verb
नमस्यति	namasyati	verb
नयति	nayati	verb
नयते	nayate	verb
नर्दति	nardati	verb
नर्मयति	narmayati	verb
नवी करोति	navī karoti	verb
नवी भवति	navī bhavati	verb
नसते	nasate	verb
नह्यति	nahyati	verb
नह्यते	nahyate	verb
नाटकी करोति	nāṭakī karoti	verb
नाथते	nāthate	verb
नामतस् पृअच्छति	nāmatas pṛacchati	verb
नावमधिरोहति	nāvamadhirohati	verb1
नाव्यति	nāvyati	verb
नासते	nāsate	verb
निकरोति	nikaroti	verb
निकषति	nikaṣati	verb
निकषते	nikaṣate	verb
निकषायते	nikaṣāyate	verb
निकुरुते	nikurute	verb
निकूजति	nikūjati	verb
निकूजते	nikūjate	verb
निकृन्तति	nikṛntati	verb
निकृन्तते	nikṛntate	verb
निक्रामति	nikrāmati	verb
निक्षति	nikṣati	verb
निक्षिपति	nikṣipati	verb
निक्ष्वेडति	nikṣveḍati	verb
निखनति	nikhanati	verb
निगच्छति	nigacchati	verb
निगदति	nigadati	verb
निगदयति	nigadayati	verb
निगर्हते	nigarhate	verb
निगर्हयति	nigarhayati	verb
निगलति	nigalati	verb
निगायति	nigāyati	verb
निगिरति	nigirati	verb
निगिलति	nigilati	verb
निगृह्णाति	nigṛhṇāti	verb
निगृह्णीते	nigṛhṇīte	verb
निघर्षति	nigharṣati	verb
निचिकेति	niciketi	verb
निचृतति	nicṛtati	verb
निजिहीते	nijihīte	verb
नितनुते	nitanute	verb
नितनोति	nitanoti	verb
नितुदति	nitudati	verb
नितुदते	nitudate	verb
नितुदाति / -ते	nitudāti / -te	verb
नितृणत्ति	nitṛṇatti	verb
नितृन्त्ते	nitṛntte	verb
नितोशते	nitośate	verb
निदधाति	nidadhāti	verb
निदिशति	nidiśati	verb
निद्रायति	nidrāyati	verb
निद्रायते	nidrāyate	verb
निधत्ते	nidhatte	verb
निधरति	nidharati	verb
निधूनोति	nidhūnoti	verb
निध्यायति	nidhyāyati	verb
निनदति	ninadati	verb
निनयति	ninayati	verb
निनयते	ninayate	verb
निनर्दति	ninardati	verb
निन्दति	nindati	verb
निपतति	nipatati	verb
निपदयते	nipadayate	verb
निपद्यते	nipadyate	verb
निपाति	nipāti	verb
निपादयति	nipādayati	verb
निपिबति	nipibati	verb
निपीयति	nipīyati	verb
निपृणाति	nipṛṇāti	verb
निबध्नाति	nibadhnāti	verb
निबृहति	nibṛhati	verb
निबोधति	nibodhati	verb
निभनक्ति	nibhanakti	verb
निभुजति	nibhujati	verb
निभृतीकृ	nibhṛtīkṛ	verb
निमज्जति	nimajjati	verb
निमज्जते	nimajjate	verb
निमज्जयति	nimajjayati	verb
निमन्त्रयति	nimantrayati	verb
निमन्त्रयते	nimantrayate	verb
निमार्ष्टि	nimārṣṭi	verb
निमिनोति	niminoti	verb
निमिमीते	nimimīte	verb
निमिषति	nimiṣati	verb
निमीलति	nimīlati	verb
निमृजति	nimṛjati	verb
निमृजते	nimṛjate	verb
निमृद्नाति	nimṛdnāti	verb
निमृष्टे	nimṛṣṭe	verb
निम्नयति	nimnayati	verb
निम्यक्षति	nimyakṣati	verb
निम्रियते	nimriyate	verb
निम्रोचति	nimrocati	verb
नियच्छति	niyacchati	verb
नियन्त्रयति	niyantrayati	verb
नियाति	niyāti	verb
नियुङ्क्ते	niyuṅkte	verb
नियुनक्ति	niyunakti	verb
नियुवति	niyuvati	verb
नियुवते	niyuvate	verb
नियोजयति	niyojayati	verb
नियौति	niyauti	verb
निरध्यति	niradhyati	verb
निरमते	niramate	verb
निरर्जति	nirarjati	verb
निरवयजते	niravayajate	verb
निरसनं करोति	nirasanaṃ karoti	verb
निरस्यति	nirasyati	verb
निरस्यते	nirasyate	verb
निराकरोति	nirākaroti	verb
निराचष्टे	nirācaṣṭe	verb
निरावहति	nirāvahati	verb
निराविशति	nirāviśati	verb
निरिणाति	niriṇāti	verb
निरिणीते	niriṇīte	verb
निरियर्ति	niriyarti	verb
निरीक्षते	nirīkṣate	verb
निरुणद्धि	niruṇaddhi	verb
निरुत्तरी करोति	niruttarī karoti	verb
निरुन्द्धे	nirunddhe	verb
निरुष्णतां नयति	niruṣṇatāṃ nayati	verb
निरूपयति	nirūpayati	verb
निरेति	nireti	verb
निर्गच्छति	nirgacchati	verb
निर्जयति	nirjayati	verb
निर्णयति	nirṇayati	verb
निर्णयते	nirṇayate	verb
निर्णुदति	nirṇudati	verb
निर्णेनेक्ति	nirṇenekti	verb
निर्दशति	nirdaśati	verb
निर्दिशति	nirdiśati	verb
निर्दृणाति	nirdṛṇāti	verb
निर्द्रवति	nirdravati	verb
निर्धनी करोति	nirdhanī karoti	verb
निर्धनी भवति	nirdhanī bhavati	verb
निर्धयति	nirdhayati	verb
निर्धरति	nirdharati	verb
निर्धूनुते	nirdhūnute	verb
निर्धूनोति	nirdhūnoti	verb
निर्बध्नाति	nirbadhnāti	verb
निर्बली करोति	nirbalī karoti	verb
निर्ब्रवीति	nirbravīti	verb
निर्भजति	nirbhajati	verb
निर्भजते	nirbhajate	verb
निर्भनक्ति	nirbhanakti	verb
निर्भप्सति	nirbhapsati	verb
निर्भर्त्सयति	nirbhartsayati	verb
निर्भाति	nirbhāti	verb
निर्भिनत्ति	nirbhinatti	verb
निर्भुजति	nirbhujati	verb
निर्मज्जति	nirmajjati	verb
निर्मथति	nirmathati	verb
निर्मथते	nirmathate	verb
निर्मथ्नाति	nirmathnāti	verb
निर्मन्थति	nirmanthati	verb
निर्मन्थते	nirmanthate	verb
निर्माति	nirmāti	verb
निर्मिणोति	nirmiṇoti	verb
निर्मिमीते	nirmimīte	verb
निर्मुञ्चति	nirmuñcati	verb
निर्मुष्णाति	nirmuṣṇāti	verb
निर्मूलयति	nirmūlayati	verb
निर्याचति	niryācati	verb
निर्याचते	niryācate	verb
निर्यातयति	niryātayati	verb
निर्याति	niryāti	verb
निर्यापयति	niryāpayati	verb
निर्येषति	niryeṣati	verb
निर्लिखति	nirlikhati	verb
निर्लुण्ठति	nirluṇṭhati	verb
निर्लोचते	nirlocate	verb
निर्वक्ति	nirvakti	verb
निर्वञ्चते	nirvañcate	verb
निर्वदति	nirvadati	verb
निर्वदते	nirvadate	verb
निर्वधति	nirvadhati	verb
निर्वपति	nirvapati	verb
निर्वपते	nirvapate	verb
निर्वमति	nirvamati	verb
निर्वर्णयति	nirvarṇayati	verb
निर्वर्तते	nirvartate	verb
निर्वसति	nirvasati	verb
निर्वहति	nirvahati	verb
निर्वाति	nirvāti	verb
निर्वापयति	nirvāpayati	verb
निर्वायति	nirvāyati	verb
निर्विध्यति	nirvidhyati	verb
निर्विन्दति	nirvindati	verb
निर्विवादी करोति	nirvivādī karoti	verb
निर्विशति	nirviśati	verb
निर्वृणीते	nirvṛṇīte	verb
निर्व्रश्चति	nirvraścati	verb
निर्हन्ति	nirhanti	verb
निर्हरति	nirharati	verb
निर्हरते	nirharate	verb
निर्ह्रसते	nirhrasate	verb
निर्ह्वयति	nirhvayati	verb
निलति	nilati	verb
निलयते	nilayate	verb
निलिम्पति	nilimpati	verb
निलिम्पते	nilimpate	verb
निलीयते	nilīyate	verb
निवपति	nivapati	verb
निवर्तते	nivartate	verb
निवसति	nivasati	verb
निवस्ते	nivaste	verb
निवहति	nivahati	verb
निवहते	nivahate	verb
निवारयति	nivārayati	verb
निवासयति	nivāsayati	verb
निविशते	niviśate	verb
निवृणोति	nivṛṇoti	verb
निवेत्ति	nivetti	verb
निवेशयति	niveśayati	verb
निशमयति	niśamayati	verb
निशामयति	niśāmayati	verb
निशाम्यति	niśāmyati	verb
निशिशाति	niśiśāti	verb
निशुम्भति	niśumbhati	verb
निश्चयं करोति	niścayaṃ karoti	verb
निश्चरति	niścarati	verb
निश्चिनोति	niścinoti	verb
निश्चृतति	niścṛtati	verb
निश्चेष्टी भवति	niśceṣṭī bhavati	verb
निश्चोतते	niścotate	verb
निश्यति	niśyati	verb
निश्वसति	niśvasati	verb
निश्वसिति	niśvasiti	verb
निषदति	niṣadati	verb
निषिञ्चति	niṣiñcati	verb
निषीदति	niṣīdati	verb
निषेदति	niṣedati	verb1
निषेधति	niṣedhati	verb
निषेवते	niṣevate	verb
निष्करुणी करोति	niṣkaruṇī karoti	verb
निष्करोति	niṣkaroti	verb
निष्कामषी भवति	niṣkāmaṣī bhavati	verb
निष्कासयति	niṣkāsayati	verb
निष्कुरुते	niṣkurute	verb
निष्कुला करोति	niṣkulā karoti	verb
निष्कुली करोति	niṣkulī karoti	verb
निष्कुषति	niṣkuṣati	verb
निष्क्रमते	niṣkramate	verb
निष्क्रामति	niṣkrāmati	verb
निष्क्रियं करोति	niṣkriyaṃ karoti	verb
निष्क्रियं भवति	niṣkriyaṃ bhavati	verb
निष्क्रीणाति	niṣkrīṇāti	verb
निष्क्रीणीते	niṣkrīṇīte	verb
निष्खिदति	niṣkhidati	verb
निष्टपति	niṣṭapati	verb
निष्ट्यायते	niṣṭyāyate	verb
निष्पतति	niṣpatati	verb
निष्पत्त्रयति	niṣpattrayati	verb
निष्पत्त्रा करोति	niṣpattrā karoti	verb
निष्पन्दतरी भवति	niṣpandatarī bhavati	verb
निष्पिनष्टि	niṣpinaṣṭi	verb
निष्पीडयति	niṣpīḍayati	verb
निष्पुनाति	niṣpunāti	verb
निष्फलयति	niṣphalayati	verb
निष्फली करोति	niṣphalī karoti	verb
निष्यति	niṣyati	verb
निस्तक्षति	nistakṣati	verb
निस्तरति	nistarati	verb
निस्तिष्ठति	nistiṣṭhati	verb
निस्तुदति	nistudati	verb
निस्तुषी करोति	nistuṣī karoti	verb
निस्तृणोति	nistṛṇoti	verb
निस्त्वचि करोति	nistvaci karoti	verb
निस्पृशति	nispṛśati	verb
निस्यन्दते	nisyandate	verb
निहन्ति	nihanti	verb
निह्नवते	nihnavate	verb
निह्वयते	nihvayate	verb
निःशाखी करोति	niḥśākhī karoti	verb
निःशास्ति	niḥśāsti	verb
निःशृणाति	niḥśṛṇāti	verb
निःशेते	niḥśete	verb
निःशेषयति	niḥśeṣayati	verb
निःश्वसिति	niḥśvasiti	verb
निःषुवति	niḥṣuvati	verb
निःषेधति	niḥṣedhati	verb
निःष्ठीवति	niḥṣṭhīvati	verb
निःष्ठीव्यति	niḥṣṭhīvyati	verb
निःसरति	niḥsarati	verb
निःसर्पति	niḥsarpati	verb
निःस्वरति	niḥsvarati	verb
नीचतयायाति	nīcatayāyāti	verb
नीरिणाति	nīriṇāti	verb
नीरिन्णीते	nīrinṇīte	verb
नीलायति	nīlāyati	verb
नीलायते	nīlāyate	verb
नीहारी करोति	nīhārī karoti	verb
नुदति / -ते	nudati / -te	verb
नुदति	nudati	verb
नुदते	nudate	verb
नूतनयति	nūtanayati	verb
नूयते	nūyate	verb
नृत्यति	nṛtyati	verb
नृपत्वं करोति	nṛpatvaṃ karoti	verb
नेत्रे निमीलयति	netre nimīlayati	verb
नेदति	nedati	verb
नेषति	neṣati	verb
नेषते	neṣate	verb
नोत्स्यति	notsyati	verb
नोदयति	nodayati	verb
नोनवीति	nonavīti	verb
नौकया अपप्लवते	naukayā apaplavate	verb
नौकां वहति	naukāṃ vahati	verb
नौति	nauti	verb
नौ भवति	nau bhavati	verb
न्यक् करोति	nyak karoti	verb
न्यक् भवति	nyak bhavati	verb
न्यञ्चति	nyañcati	verb
न्यनक्ति	nyanakti	verb
न्यवचरति	nyavacarati	verb
न्यवेक्षते	nyavekṣate	verb
न्यसति	nyasati	verb
न्यस्यति	nyasyati	verb
न्यादधाति	nyādadhāti	verb
न्याद्रवति	nyādravati	verb
न्यानयति	nyānayati	verb
न्यीर्ते	nyīrte	verb
न्युनत्ति	nyunatti	verb
न्युब्जति	nyubjati	verb
न्यूङ्खयति	nyūṅkhayati	verb
न्यूनतमं करोति	nyūnatamaṃ karoti	verb
न्यूनयति	nyūnayati	verb
न्यूनी करोति	nyūnī karoti	verb
न्यृञ्जते	nyṛñjate	verb
न्यृषति	nyṛṣati	verb
न्येति	nyeti	verb
न्योषति	nyoṣati	verb
पङ्कयति	paṅkayati	verb
पचति	pacati	verb
पचते	pacate	verb
पञ्चताम् उपनयति	pañcatām upanayati	verb
पञ्चतां गच्छति	pañcatāṃ gacchati	verb
पञ्चतां याति	pañcatāṃ yāti	verb
पटूकरोति	paṭūkaroti	verb
पटू करोति	paṭū karoti	verb
पठति	paṭhati	verb
पणते	paṇate	verb
पणायति	paṇāyati	verb
पणायते	paṇāyate	verb
पतति	patati	verb
पतीयति	patīyati	verb
पत्त्रयति	pattrayati	verb
पत्त्रयते	pattrayate	verb
पत्यते	patyate	verb
पदविन्यसणम् करोति	padavinyasaṇam karoti	verb
पदी करोति	padī karoti	verb
पदं निदधाति	padaṃ nidadhāti	verb
पद्यते	padyate	verb
पनते	panate	verb
पनस्यते	panasyate	verb
पयते	payate	verb
पयस्काम्यति	payaskāmyati	verb
पयोधरी भवति	payodharī bhavati	verb
परसवर्णी भवति	parasavarṇī bhavati	verb
पराकरोति	parākaroti	verb
पराकिरति	parākirati	verb
पराक्रमति	parākramati	verb
पराक्रमते	parākramate	verb
पराक्षिपति	parākṣipati	verb
पराक्षिपते	parākṣipate	verb
पराख्याति	parākhyāti	verb
परागच्छति	parāgacchati	verb
पराङ्मुखी करोति	parāṅmukhī karoti	verb
पराङ्मुखी भवति	parāṅmukhī bhavati	verb
पराचरति	parācarati	verb
पराजयते	parājayate	verb
पराजिहीते	parājihīte	verb
पराणयति	parāṇayati	verb
पराणयते	parāṇayate	verb
पराणुदति	parāṇudati	verb
पराणुदते	parāṇudate	verb
पराददाति	parādadāti	verb
पराददृशे	parādadṛśe	verb
पराद्रवति	parādravati	verb
परापतति	parāpatati	verb
परापुनाति	parāpunāti	verb
पराभवति	parābhavati	verb
परामिनोति	parāminoti	verb
परामृशति	parāmṛśati	verb
परायाति	parāyāti	verb
परावक्ति	parāvakti	verb
परावधति	parāvadhati	verb
परावर्तते	parāvartate	verb
पराविध्यति	parāvidhyati	verb
परावृणक्ति	parāvṛṇakti	verb
परासुवति	parāsuvati	verb
परासृजति	parāsṛjati	verb
परास्तभ्नाति	parāstabhnāti	verb
परास्यति	parāsyati	verb
पराहन्ति	parāhanti	verb
परिकर्मयति	parikarmayati	verb
परिकर्शयति	parikarśayati	verb
परिकर्षति	parikarṣati	verb
परिकर्षते	parikarṣate	verb
परिकलयति	parikalayati	verb
परिकालयति	parikālayati	verb
परिकिरति	parikirati	verb
परिकीर्तयति	parikīrtayati	verb
परिकुप्यति	parikupyati	verb
परिकृन्तति	parikṛntati	verb
परिक्रामति	parikrāmati	verb
परिक्रीणीते	parikrīṇīte	verb
परिक्रुध्यति	parikrudhyati	verb
परिक्रोशति	parikrośati	verb
परिक्लिश्यति	parikliśyati	verb
परिक्लिश्यते	parikliśyate	verb
परिक्वथति	parikvathati	verb
परिक्षालयति	parikṣālayati	verb
परिक्षिपति	parikṣipati	verb
परिखण्डयति	parikhaṇḍayati	verb
परिखिद्यति	parikhidyati	verb
परिख्याति	parikhyāti	verb
परिगच्छति	parigacchati	verb
परिगणयति	parigaṇayati	verb
परिगर्जति	parigarjati	verb
परिगर्हते	parigarhate	verb
परिगृह्णाति	parigṛhṇāti	verb
परिगृह्णीते	parigṛhṇīte	verb
परिग्रसति	parigrasati	verb
परिग्रसते	parigrasate	verb
परिघट्टयति	parighaṭṭayati	verb
परिचरति	paricarati	verb
परिचष्टे	paricaṣṭe	verb
परिचारयति	paricārayati	verb
परिचिनुते	paricinute	verb
परिचिनोति	paricinoti	verb
परिचिन्तयति	paricintayati	verb
परिचीयते	paricīyate	verb
परिचुम्बति	paricumbati	verb
परिच्छिनोति	paricchinoti	verb
परिजयति	parijayati	verb
परिजल्पति	parijalpati	verb
परिजहाति	parijahāti	verb
परिजानाति	parijānāti	verb
परिजानीते	parijānīte	verb
परिजिगाति	parijigāti	verb
परिजिघ्रति	parijighrati	verb
परिजीर्यति	parijīryati	verb
परिजीर्यते	parijīryate	verb
परिज्वलति	parijvalati	verb
परिणदति	pariṇadati	verb
परिणमति	pariṇamati	verb
परिणमते	pariṇamate	verb
परिणयति	pariṇayati	verb
परिणयते	pariṇayate	verb
परिणह्यति	pariṇahyati	verb
परिणिहन्ति	pariṇihanti	verb
परितपति	paritapati	verb
परितर्कयति	paritarkayati	verb
परिताम्यति	paritāmyati	verb
परितिष्ठति	paritiṣṭhati	verb
परितिष्ठते	paritiṣṭhate	verb
परितुदति	paritudati	verb
परितृणत्ति	paritṛṇatti	verb
परित्यजति	parityajati	verb
परित्राति	paritrāti	verb
परित्रायते	paritrāyate	verb
परिदत्ते	paridatte	verb
परिददाति	paridadāti	verb
परिदधाति	paridadhāti	verb
परिदिदेष्टि	paridideṣṭi	verb
परिदिवयति	paridivayati	verb
परिदीप्यते	paridīpyate	verb
परिदृणाति	paridṛṇāti	verb
परिदेवति	paridevati	verb
परिधत्ते	paridhatte	verb
परिधावति	paridhāvati	verb
परिनिन्दति	parinindati	verb
परिनिपद्यते	parinipadyate	verb
परिनिर्णेनेक्ति	parinirṇenekti	verb
परिनिर्वाति	parinirvāti	verb
परिनिषिञ्चति	pariniṣiñcati	verb
परिनिषीदति	pariniṣīdati	verb
परिनिःस्तनति	pariniḥstanati	verb
परिपचति	paripacati	verb
परिपठति	paripaṭhati	verb
परिपतति	paripatati	verb
परिपन्थयति	paripanthayati	verb
परिपश्यति	paripaśyati	verb
परिपिङ्ग करोति	paripiṅga karoti	verb
परिपिनष्टि	paripinaṣṭi	verb
परिपीडयति	paripīḍayati	verb
परिपुनाति	paripunāti	verb
परिपूजयति	paripūjayati	verb
परिपृच्छति	paripṛcchati	verb
परिपृच्छते	paripṛcchate	verb
परिप्रधन्वति	paripradhanvati	verb
परिप्रवक्ति	paripravakti	verb
परिप्रुष्णोति	paripruṣṇoti	verb
परिप्लवते	pariplavate	verb
परिबध्नीते	paribadhnīte	verb
परिबाधते	paribādhate	verb
परिबृंहति	paribṛṃhati	verb
परिबृंहते	paribṛṃhate	verb
परिब्रवीति	paribravīti	verb
परिभक्षयति	paribhakṣayati	verb
परिभरति	paribharati	verb
परिभरते	paribharate	verb
परिभर्त्सति	paribhartsati	verb
परिभर्त्सयति	paribhartsayati	verb
परिभवति	paribhavati	verb
परिभवते	paribhavate	verb
परिभाषते	paribhāṣate	verb
परिभुङ्क्ते	paribhuṅkte	verb
परिभुजति	paribhujati	verb
परिभुनक्ति	paribhunakti	verb
परिभूषति	paribhūṣati	verb
परिभ्रमति	paribhramati	verb
परिभ्राजते	paribhrājate	verb
परिभ्राम्यति	paribhrāmyati	verb
परिभ्रंशति	paribhraṃśati	verb
परिमथ्नाति	parimathnāti	verb
परिमन्यते	parimanyate	verb
परिमर्दति	parimardati	verb
परिमार्जति	parimārjati	verb
परिमार्जयति	parimārjayati	verb
परिमार्ष्टव्यम्	parimārṣṭavyam	verb
परिमार्ष्टि	parimārṣṭi	verb
परिमिमीते	parimimīte	verb
परिमुञ्चति	parimuñcati	verb
परिमुषति	parimuṣati	verb
परिमुष्णाति	parimuṣṇāti	verb
परिमुह्यति	parimuhyati	verb
परिमुह्यते	parimuhyate	verb
परिमृगयते	parimṛgayate	verb
परिमृजति	parimṛjati	verb
परिमृद्नाति	parimṛdnāti	verb
परिमृशति	parimṛśati	verb
परिमृशते	parimṛśate	verb
परिमोक्षयति	parimokṣayati	verb
परिम्लायते	parimlāyate	verb
परियजति	pariyajati	verb
परियतते	pariyatate	verb
परियाति	pariyāti	verb
परिरक्षति	parirakṣati	verb
परिरभते	parirabhate	verb
परिरमति	pariramati	verb
परिरिहति	paririhati	verb
परिरुणद्धि	pariruṇaddhi	verb
परिलङ्घयति	parilaṅghayati	verb
परिलम्बते	parilambate	verb
परिलुम्पति	parilumpati	verb
परिलेढि	parileḍhi	verb
परिलोकयति	parilokayati	verb
परिलोभते	parilobhate	verb
परिवञ्चति	parivañcati	verb
परिवदति	parivadati	verb
परिवन्दति	parivandati	verb
परिवपति	parivapati	verb
परिवयति	parivayati	verb
परिवयते	parivayate	verb
परिवरति	parivarati	verb
परिवरते	parivarate	verb
परिवर्तते	parivartate	verb
परिवर्तयति	parivartayati	verb
परिवर्धते	parivardhate	verb
परिवसति	parivasati	verb
परिवस्ते	parivaste	verb
परिवहति	parivahati	verb
परिवासयति	parivāsayati	verb
परिविधावति	parividhāvati	verb
परिविन्दति	parivindati	verb
परिविशति	pariviśati	verb
परिवृणक्ति	parivṛṇakti	verb
परिवृणीते	parivṛṇīte	verb
परिवेत्ति	parivetti	verb
परिवेषति	pariveṣati	verb
परिवेषयति	pariveṣayati	verb
परिवेष्टयति	pariveṣṭayati	verb
परिव्यथते	parivyathate	verb
परिव्रजति	parivrajati	verb
परिशङ्कते	pariśaṅkate	verb
परिशपति	pariśapati	verb
परिशपते	pariśapate	verb
परिशिनष्टि	pariśinaṣṭi	verb
परिशीलयति	pariśīlayati	verb
परिशुद्धिं करोति	pariśuddhiṃ karoti	verb
परिशुध्यति	pariśudhyati	verb
परिशुध्यते	pariśudhyate	verb
परिशुष्यति	pariśuṣyati	verb
परिशुष्यते	pariśuṣyate	verb
परिशेते	pariśete	verb
परिशोचति	pariśocati	verb
परिशोचते	pariśocate	verb
परिश्रयति	pariśrayati	verb
परिश्राम्यति	pariśrāmyati	verb
परिषदति	pariṣadati	verb
परिषहते	pariṣahate	verb
परिषिञ्चति	pariṣiñcati	verb
परिषीदति	pariṣīdati	verb
परिषुणोति	pariṣuṇoti	verb
परिषेवते	pariṣevate	verb
परिष्कृणोति	pariṣkṛṇoti	verb
परिष्टोभति	pariṣṭobhati	verb
परिष्वजति	pariṣvajati	verb
परिष्वजते	pariṣvajate	verb
परिसङ्क्षिपति	parisaṅkṣipati	verb
परिसङ्ख्याति	parisaṅkhyāti	verb
परिसञ्चष्टे	parisañcaṣṭe	verb
परिसन्तपति	parisantapati	verb
परिसम्भवति	parisambhavati	verb
परिसरति	parisarati	verb
परिसर्पति	parisarpati	verb
परिसर्पते	parisarpate	verb
परिसंलेढि	parisaṃleḍhi	verb
परिसंस्तभ्नोति	parisaṃstabhnoti	verb
परिसंस्तौति	parisaṃstauti	verb
परिस्खलति	pariskhalati	verb
परिस्तृणाति	paristṛṇāti	verb
परिस्तृणीते	paristṛṇīte	verb
परिस्तृणुते	paristṛṇute	verb
परिस्तृणोति	paristṛṇoti	verb
परिस्तृत	paristṛta	verb
परिस्पन्दते	parispandate	verb
परिस्फुरति	parisphurati	verb
परिस्रवति	parisravati	verb
परिहन्ति	parihanti	verb
परिहरति	pariharati	verb
परिहरते	pariharate	verb
परिहसति	parihasati	verb
परिहासं करोति	parihāsaṃ karoti	verb
परीक्षते	parīkṣate	verb
परीध्यायति	parīdhyāyati	verb
परैति	paraiti	verb
पर्णयति	parṇayati	verb
पर्णशालायते	parṇaśālāyate	verb
पर्थयति	parthayati	verb
पर्यङ्खयति	paryaṅkhayati	verb
पर्यञ्चति	paryañcati	verb
पर्यटति	paryaṭati	verb
पर्यनुयुनक्ति	paryanuyunakti	verb
पर्यवतिष्ठते	paryavatiṣṭhate	verb
पर्यवद्यति	paryavadyati	verb
पर्यवशिन्ष्टि	paryavaśinṣṭi	verb
पर्यवष्टभ्नोति	paryavaṣṭabhnoti	verb
पर्यवष्टम्भ्	paryavaṣṭambh	verb
पर्यवस्यति	paryavasyati	verb
पर्यवैति	paryavaiti	verb
पर्यस्ति	paryasti	verb
पर्यस्यति	paryasyati	verb
पर्यस्यते	paryasyate	verb
पर्या करोति	paryā karoti	verb
पर्याकुलयति	paryākulayati	verb
पर्यागच्छति	paryāgacchati	verb
पर्यागलति	paryāgalati	verb
पर्याजिगाति	paryājigāti	verb
पर्यातनोति	paryātanoti	verb
पर्यादत्ते	paryādatte	verb
पर्यादधाति	paryādadhāti	verb
पर्या भवति	paryā bhavati	verb
पर्यामृशति	paryāmṛśati	verb
पर्यायाति	paryāyāti	verb
पर्यावर्तते	paryāvartate	verb
पर्यास्ते	paryāste	verb
पर्याहरति	paryāharati	verb
पर्याह्वयते	paryāhvayate	verb
पर्युत्सुकी भवति	paryutsukī bhavati	verb
पर्युत्सृजति	paryutsṛjati	verb
पर्युद्विजति	paryudvijati	verb
पर्युपतिष्ठति	paryupatiṣṭhati	verb
पर्युपहवते	paryupahavate	verb
पर्युपास्ते	paryupāste	verb
पर्यूहति	paryūhati	verb
पर्यूहते	paryūhate	verb
पर्येति	paryeti	verb
पर्यैति	paryaiti	verb
पर्वति	parvati	verb
पर्षति	parṣati	verb
पर्षते	parṣate	verb
पलायते	palāyate	verb
पल्पूलयति	palpūlayati	verb
पल्यङ्गयते	palyaṅgayate	verb
पल्लवति	pallavati	verb
पल्लवयति	pallavayati	verb
पवते	pavate	verb
पवित्रयति	pavitrayati	verb
पवित्री करोति	pavitrī karoti	verb
पवित्री भवति	pavitrī bhavati	verb
पश्चात् शोचति	paścāt śocati	verb1
पश्यति	paśyati	verb
पश्यते	paśyate	verb
पश्यामि	paśyāmi	verb
पषति	paṣati	verb
पषते	paṣate	verb
पषयति	paṣayati	verb
पाटली करोति	pāṭalī karoti	verb
पाठयति / ते	pāṭhayati / te	verb
पातयति	pātayati	verb
पाति	pāti	verb
पात्रयति	pātrayati	verb
पात्री करोति	pātrī karoti	verb
पात्री भवति	pātrī bhavati	verb
पादाभ्यां व्रजति	pādābhyāṃ vrajati	verb
पापयते	pāpayate	verb
पायति	pāyati	verb
पारयति	pārayati	verb
पारावतमालायते	pārāvatamālāyate	verb
पालयति	pālayati	verb
पाशयति	pāśayati	verb
पाषयति	pāṣayati	verb
पास्यति	pāsyati	verb
पिङ्क्ते	piṅkte	verb
पिच्चयति	piccayati	verb
पिच्छयति	picchayati	verb
पिच्छिली करोति	picchilī karoti	verb
पिण्डते	piṇḍate	verb
पिण्डयति	piṇḍayati	verb
पिण्डी करोति	piṇḍī karoti	verb
पिण्डी भवति	piṇḍī bhavati	verb
पिनयति	pinayati	verb
पिपर्ति	piparti	verb
पिबति	pibati	verb
पिबन्	piban	verb
पिशुनयति	piśunayati	verb
पिस्यति	pisyati	verb
पिंशति	piṃśati	verb
पिंशते	piṃśate	verb
पीठायते	pīṭhāyate	verb
पीडयति	pīḍayati	verb
पीडायते	pīḍāyate	verb
पीयति	pīyati	verb
पीयते	pīyate	verb
पीयूषति	pīyūṣati	verb
पुआयुनक्ति	puāyunakti	verb
पुआरोहति	puārohati	verb
पुटचिह्नं करोति	puṭacihnaṃ karoti	verb
पुटति	puṭati	verb
पुटीकरोति	puṭīkaroti	verb
पुट्टयति	puṭṭayati	verb
पुडति	puḍati	verb
पुणति	puṇati	verb
पुण्डति	puṇḍati	verb
पुण्यी करोति	puṇyī karoti	verb
पुत्री भवति	putrī bhavati	verb
पुन:प्रवर्तयति	puna:pravartayati	verb
पुनरादधाति	punarādadhāti	verb
पुनरुक्ती करोति	punaruktī karoti	verb
पुनरुत्थापयति	punarutthāpayati	verb
पुनर् आ- श्वस्	punar ā- śvas	caus.
पुनर्निवेशयति	punarniveśayati	verb
पुनर् याचति	punar yācati	verb
पुरति	purati	verb
पुरतः करोति	purataḥ karoti	verb
पुरस्करोति	puraskaroti	verb
पुराण्यति	purāṇyati	verb
पुरावृत्ते रक्षति	purāvṛtte rakṣati	verb
पुरोदधाति	purodadhāti	verb
पुरोधत्ते	purodhatte	verb
पुष्करायते	puṣkarāyate	verb
पुष्णाति	puṣṇāti	verb
पुष्पमेघी करोति	puṣpameghī karoti	verb
पुष्पायति	puṣpāyati	verb
पुस्तयति	pustayati	verb
पूजयति	pūjayati	verb
पूतिकुष्माण्डायते	pūtikuṣmāṇḍāyate	verb
पूयति	pūyati	verb
पूयते	pūyate	verb
पूरयति	pūrayati	verb
पूर्तयति	pūrtayati	verb
पूर्वति	pūrvati	verb
पूर्वयति	pūrvayati	verb
पूर्वस्थितिम् आनयति	pūrvasthitim ānayati	verb
पूषति	pūṣati	verb
पूःकाम्यति	pūḥkāmyati	verb
पृङ्क्ते	pṛṅkte	verb
पृच्छति	pṛcchati	verb
पृडति	pṛḍati	verb
पृणक्ति	pṛṇakti	verb
पृणाति	pṛṇāti	verb
पृणोति	pṛṇoti	verb
पृतन्यति	pṛtanyati	verb
पृथक् करोति	pṛthak karoti	verb
पृथू करोति	pṛthū karoti	verb
पृष्ठकेकरोति	pṛṣṭhakekaroti	verb
पृष्ठचिह्नं करोति	pṛṣṭhacihnaṃ karoti	verb
पेणति	peṇati	verb
पेलयति	pelayati	verb
पेषते	peṣate	verb
पेषी करोति	peṣī karoti	verb
पैणति	paiṇati	verb
पोट्टली करोति	poṭṭalī karoti	verb
पोताद् भारम् अपनयति	potād bhāram apanayati	verb1
पोसयति	posayati	verb
प्रकटयति	prakaṭayati	verb
प्रकटायति	prakaṭāyati	verb
प्रकटीकरोति	prakaṭīkaroti	verb
प्रकटी करोति	prakaṭī karoti	verb
प्रकटी भवति	prakaṭī bhavati	verb
प्रकथयति	prakathayati	verb
प्रकम्पते	prakampate	verb
प्रकरोति	prakaroti	verb
प्रकर्षति	prakarṣati	verb
प्रकल्पते	prakalpate	verb
प्रकाङ्क्षति	prakāṅkṣati	verb
प्रकालयति	prakālayati	verb
प्रकाशते	prakāśate	verb
प्रकाशी करोति	prakāśī karoti	verb
प्रकिरति	prakirati	verb
प्रकीर्तयति	prakīrtayati	verb
प्रकुटति	prakuṭati	verb
प्रकुरुते	prakurute	verb
प्रकूजति	prakūjati	verb
प्रकृणुते	prakṛṇute	verb
प्रकृणोति	prakṛṇoti	verb
प्रक्रमते	prakramate	verb
प्रक्रामति	prakrāmati	verb
प्रक्रीडति	prakrīḍati	verb
प्रक्रीडते	prakrīḍate	verb
प्रक्रोशति	prakrośati	verb
प्रक्लिद्यते	praklidyate	verb
प्रक्षरति	prakṣarati	verb
प्रक्षलयति	prakṣalayati	verb
प्रक्षायति	prakṣāyati	verb
प्रक्षालयति	prakṣālayati	verb
प्रक्षिणाति	prakṣiṇāti	verb
प्रक्षिपति	prakṣipati	verb
प्रक्षिपते	prakṣipate	verb
प्रक्षुणत्ति	prakṣuṇatti	verb
प्रक्षुभ्यति	prakṣubhyati	verb
प्रक्षोभते	prakṣobhate	verb
प्रक्ष्णौति	prakṣṇauti	verb
प्रखनति	prakhanati	verb
प्रखादति	prakhādati	verb
प्रखिन्दति	prakhindati	verb
प्रख्याति	prakhyāti	verb
प्रगच्छति	pragacchati	verb
प्रगणयति	pragaṇayati	verb
प्रगल्भते	pragalbhate	verb
प्रगायति	pragāyati	verb
प्रगाहते	pragāhate	verb
प्रगुणयति	praguṇayati	verb
प्रगुणी करोति	praguṇī karoti	verb
प्रगुरते	pragurate	verb
प्रगृणाति	pragṛṇāti	verb
प्रगृह्णाति	pragṛhṇāti	verb
प्रगृह्णीते	pragṛhṇīte	verb
प्रग्रथति	pragrathati	verb
प्रग्रथ्नाति	pragrathnāti	verb
प्रग्रसति	pragrasati	verb
प्रग्लायति	praglāyati	verb
प्रघरति	pragharati	verb
प्रघर्षति	pragharṣati	verb
प्रचरति	pracarati	verb
प्रचलति	pracalati	verb
प्रचलायति	pracalāyati	verb
प्रचष्टे	pracaṣṭe	verb
प्रचातयते	pracātayate	verb
प्रचारलोपं करोति	pracāralopaṃ karoti	verb
प्रचिनुते	pracinute	verb
प्रचिनोति	pracinoti	verb
प्रचृतति	pracṛtati	verb
प्रच्छन्नी भवति	pracchannī bhavati	verb
प्रच्छादयति	pracchādayati	verb
प्रच्छादयते	pracchādayate	verb
प्रच्छिनत्ति	pracchinatti	verb
प्रच्छिन्त्ते	pracchintte	verb
प्रच्छ्यति	pracchyati	verb
प्रच्यवते	pracyavate	verb
प्रजपति	prajapati	verb
प्रजवते	prajavate	verb
प्रजहाति	prajahāti	verb
प्रजागर्ति	prajāgarti	verb
प्रजानाति	prajānāti	verb
प्रजायते	prajāyate	verb
प्रजिगाति	prajigāti	verb
प्रजिन्वति	prajinvati	verb
प्रजिहीते	prajihīte	verb
प्रजीर्यति	prajīryati	verb
प्रजृम्भते	prajṛmbhate	verb
प्रज्वलति / -ते	prajvalati / -te	verb
प्रज्वलति	prajvalati	verb
प्रञ्जति	prañjati	verb
प्रणदति	praṇadati	verb
प्रणभते	praṇabhate	verb
प्रणमति	praṇamati	verb
प्रणमते	praṇamate	verb
प्रणयति	praṇayati	verb1
प्रणयति	praṇayati	verb
प्रणयते	praṇayate	verb
प्रणशति	praṇaśati	verb
प्रणश्यति	praṇaśyati	verb
प्रणिजानाति	praṇijānāti	verb
प्रणिदधाति	praṇidadhāti	verb
प्रणिधत्ते	praṇidhatte	verb
प्रणिनदति	praṇinadati	verb
प्रणिन्दति	praṇindati	verb
प्रणिपतति	praṇipatati	verb
प्रणिहन्ति	praṇihanti	verb
प्रणुदति	praṇudati	verb
प्रणुदते	praṇudate	verb
प्रतक्षति	pratakṣati	verb
प्रतनु करोति	pratanu karoti	verb
प्रतनुते	pratanute	verb
प्रतनू करोति	pratanū karoti	verb
प्रतनोति	pratanoti	verb
प्रतपति	pratapati	verb
प्रतरति	pratarati	verb
प्रतरते	pratarate	verb
प्रतर्कयति	pratarkayati	verb
प्रताडयति	pratāḍayati	verb
प्रताम्यति	pratāmyati	verb
प्रतिकरोति	pratikaroti	verb
प्रतिकल्पते	pratikalpate	verb
प्रतिकुरुते	pratikurute	verb
प्रतिकूलयति	pratikūlayati	verb
प्रतिकृतिं लिखति	pratikṛtiṃ likhati	verb
प्रतिक्रामति	pratikrāmati	verb
प्रतिक्रुधयति	pratikrudhayati	verb
प्रतिक्षते	pratikṣate	verb
प्रतिक्षिपति	pratikṣipati	verb
प्रतिख्याति	pratikhyāti	verb
प्रतिगच्छति	pratigacchati	verb
प्रतिगर्जति	pratigarjati	verb
प्रतिगृणाति	pratigṛṇāti	verb
प्रतिगृणीते	pratigṛṇīte	verb
प्रतिगृह्णाति	pratigṛhṇāti	verb
प्रतिगृह्णीते	pratigṛhṇīte	verb
प्रतिच्छादयति	praticchādayati	verb
प्रतिच्छिनत्ति	praticchinatti	verb
प्रतिजपति	pratijapati	verb
प्रतिजयति	pratijayati	verb
प्रतिजरते	pratijarate	verb
प्रतिजल्पति	pratijalpati	verb
प्रतिजागर्ति	pratijāgarti	verb
प्रतिजानाति	pratijānāti	verb
प्रतिजानीते	pratijānīte	verb
प्रतिजुषते	pratijuṣate	verb
प्रतिजुहोति	pratijuhoti	verb
प्रतिज्वलति	pratijvalati	verb
प्रतितर्जति	pratitarjati	verb
प्रतितिष्ठति	pratitiṣṭhati	verb
प्रतितिष्ठते	pratitiṣṭhate	verb
प्रतिदत्ते	pratidatte	verb
प्रतिददाति	pratidadāti	verb
प्रतिदधाति	pratidadhāti	verb
प्रतिदहति	pratidahati	verb
प्रतिदीव्यति	pratidīvyati	verb
प्रतिदुग्धे	pratidugdhe	verb
प्रतिदृशते	pratidṛśate	verb
प्रतिद्वन्द्वयति	pratidvandvayati	verb
प्रतिधत्ते	pratidhatte	verb
प्रतिधर्षति	pratidharṣati	verb
प्रतिनदति	pratinadati	verb
प्रतिनन्दति	pratinandati	verb
प्रतिनिगदति	pratinigadati	verb
प्रतिनिदधाति	pratinidadhāti	verb
प्रतिनिवर्तते	pratinivartate	verb
प्रतिनिवर्त्तः	pratinivarttaḥ	verb
प्रतिनिष्पुनाति	pratiniṣpunāti	verb
प्रतिनुदति	pratinudati	verb
प्रतिनुदते	pratinudate	verb
प्रतिनौति	pratinauti	verb
प्रतिपद्यते	pratipadyate	verb
प्रतिपालयति	pratipālayati	verb
प्रतिपिनष्टि	pratipinaṣṭi	verb
प्रतिपूजयति	pratipūjayati	verb
प्रतिपृच्छति	pratipṛcchati	verb
प्रतिपेदिरे	pratipedire	verb
प्रतिप्रब्रवीति	pratiprabravīti	verb
प्रतिप्रमुञ्चति	pratipramuñcati	verb
प्रतिप्रयच्छति	pratiprayacchati	verb
प्रतिप्रयुङ्क्ते	pratiprayuṅkte	verb
प्रतिप्रयुनक्ति	pratiprayunakti	verb
प्रतिप्रवक्ति	pratipravakti	verb
प्रतिप्रहिणोति	pratiprahiṇoti	verb
प्रतिफलति	pratiphalati	verb
प्रतिबध्नाति	pratibadhnāti	verb
प्रतिबध्नीते	pratibadhnīte	verb
प्रतिबाधते	pratibādhate	verb
प्रतिबिम्बयति	pratibimbayati	verb
प्रतिबिम्बी करोति	pratibimbī karoti	verb
प्रतिबुध्यते	pratibudhyate	verb
प्रतिब्रवीति	pratibravīti	verb
प्रतिब्रूवे	pratibrūve	verb
प्रतिभनक्ति	pratibhanakti	verb
प्रतिभवति	pratibhavati	verb
प्रतिभाति	pratibhāti	verb
प्रतिभाषते	pratibhāṣate	verb
प्रतिभिनत्ति	pratibhinatti	verb
प्रतिभुनक्ति	pratibhunakti	verb
प्रतिभूषति	pratibhūṣati	verb
प्रतिमनुते	pratimanute	verb
प्रतिमानम् रचयति	pratimānam racayati	verb
प्रतिमिमीते	pratimimīte	verb
प्रतिमुञ्चति	pratimuñcati	verb
प्रतिमुञ्चते	pratimuñcate	verb
प्रतियच्छति	pratiyacchati	verb
प्रतियतते	pratiyatate	verb
प्रतियाति	pratiyāti	verb
प्रतियुङ्क्ते	pratiyuṅkte	verb
प्रतियुध्यति	pratiyudhyati	verb
प्रतियुध्यते	pratiyudhyate	verb
प्रतियुनक्ति	pratiyunakti	verb
प्रतियौति	pratiyauti	verb
प्रतिरक्षति	pratirakṣati	verb
प्रतिरपति	pratirapati	verb
प्रतिरसति	pratirasati	verb
प्रतिराध्नोति	pratirādhnoti	verb
प्रतिरिहति	pratirihati	verb
प्रतिरुन्द्धे	pratirunddhe	verb
प्रतिरुन्धति	pratirundhati	verb
प्रतिरुन्धते	pratirundhate	verb
प्रतिरूपम् रचयति	pratirūpam racayati	verb
प्रतिलभते	pratilabhate	verb
प्रतिलम्बते	pratilambate	verb
प्रतिलिखति	pratilikhati	verb
प्रतिलेखं लिखति	pratilekhaṃ likhati	verb
प्रतिवक्ति	prativakti	verb
प्रतिवदति	prativadati	verb
प्रतिवन्दति	prativandati	verb
प्रतिवपति	prativapati	verb
प्रतिवर्तते	prativartate	verb
प्रतिवसति	prativasati	verb
प्रतिवस्ते	prativaste	verb
प्रतिवहति	prativahati	verb
प्रतिवारयति	prativārayati	verb
प्रतिविजहाति	prativijahāti	verb
प्रतिविजानाति	prativijānāti	verb
प्रतिविदधाति	pratividadhāti	verb
प्रतिविधत्ते	pratividhatte	verb
प्रतिविध्यति	pratividhyati	verb
प्रतिविबुध्यते	prativibudhyate	verb
प्रतिविभजति	prativibhajati	verb
प्रतिविरमति	prativiramati	verb
प्रतिविसृजति	prativisṛjati	verb
प्रतिशङ्कते	pratiśaṅkate	verb
प्रतिशुष्यति	pratiśuṣyati	verb
प्रतिशृणोति	pratiśṛṇoti	verb
प्रतिशृनाति	pratiśṛnāti	verb
प्रतिशृनोति	pratiśṛnoti	verb
प्रतिश्वसिति	pratiśvasiti	verb
प्रतिषिञ्चति	pratiṣiñcati	verb
प्रतिषेधति	pratiṣedhati	verb
प्रतिष्ठते	pratiṣṭhate	verb
प्रतिष्ठापयति	pratiṣṭhāpayati	verb
प्रतिसङ्ग्रिह्णाति	pratisaṅgrihṇāti	verb
प्रतिसङ्ग्रिह्णीते	pratisaṅgrihṇīte	verb
प्रतिसचते	pratisacate	verb
प्रतिसन्दधाति	pratisandadhāti	verb
प्रतिसन्दिशति	pratisandiśati	verb
प्रतिसन्धत्ते	pratisandhatte	verb
प्रतिसमादधाति	pratisamādadhāti	verb
प्रतिसमास्ते	pratisamāste	verb
प्रतिसरति	pratisarati	verb
प्रतिसीदति	pratisīdati	verb
प्रतिसृजति	pratisṛjati	verb
प्रतिसेधति	pratisedhati	verb
प्रतिसेवते	pratisevate	verb
प्रतिसंवेष्टते	pratisaṃveṣṭate	verb
प्रतिसंस्करोति	pratisaṃskaroti	verb
प्रतिसंस्तभ्नोति	pratisaṃstabhnoti	verb
प्रतिसंहरति	pratisaṃharati	verb
प्रतिसंहरते	pratisaṃharate	verb
प्रतिस्पर्धते	pratispardhate	verb
प्रतिस्मरति	pratismarati	verb
प्रतिस्मरते	pratismarate	verb
प्रतिस्वनति	pratisvanati	verb
प्रतिहन्ति	pratihanti	verb
प्रतिहरति	pratiharati	verb
प्रतिहरते	pratiharate	verb
प्रतिहर्यति	pratiharyati	verb
प्रतिहर्यते	pratiharyate	verb
प्रतीच्छति	pratīcchati	verb
प्रतीन्वति	pratīnvati	verb
प्रतीपायते	pratīpāyate	verb
प्रतुदति	pratudati	verb
प्रत्यक्षी करोति	pratyakṣī karoti	verb
प्रत्यक्षी भवति	pratyakṣī bhavati	verb
प्रत्यत्ति	pratyatti	verb
प्रत्यधिश्रयति	pratyadhiśrayati	verb
प्रत्यधीयते	pratyadhīyate	verb
प्रत्यनन्तरी भवति	pratyanantarī bhavati	verb
प्रत्यनुजानाति	pratyanujānāti	verb
प्रत्यनुनयति	pratyanunayati	verb
प्रत्यनुनयते	pratyanunayate	verb
प्रत्यनुभवति	pratyanubhavati	verb
प्रत्यप करोति	pratyapa karoti	verb
प्रत्यपयाति	pratyapayāti	verb
प्रत्यपवहति	pratyapavahati	verb
प्रत्यभिचरति	pratyabhicarati	verb
प्रत्यभिजानाति	pratyabhijānāti	verb
प्रत्यभिजानीते	pratyabhijānīte	verb
प्रत्यभिनन्दति	pratyabhinandati	verb
प्रत्यभिमेथति	pratyabhimethati	verb
प्रत्यभियाति	pratyabhiyāti	verb
प्रत्ययायति	pratyayāyati	verb
प्रत्यर्थयति	pratyarthayati	verb
प्रत्यवगच्छति	pratyavagacchati	verb
प्रत्यवगृह्णाति	pratyavagṛhṇāti	verb
प्रत्यवतरति	pratyavatarati	verb
प्रत्यवतिष्ठते	pratyavatiṣṭhate	verb
प्रत्यवभुजति	pratyavabhujati	verb
प्रत्यवमर्षति	pratyavamarṣati	verb
प्रत्यवमर्षते	pratyavamarṣate	verb
प्रत्यवमृशति	pratyavamṛśati	verb
प्रत्यवमृष्यति	pratyavamṛṣyati	verb
प्रत्यवमृष्यते	pratyavamṛṣyate	verb
प्रत्यवरोहति	pratyavarohati	verb
प्रत्यवसृजति	pratyavasṛjati	verb
प्रत्यवहन्ति	pratyavahanti	verb
प्रत्यवहरति	pratyavaharati	verb
प्रत्यवीति	pratyavīti	verb
प्रत्यवेक्षते	pratyavekṣate	verb
प्रत्याख्याति	pratyākhyāti	verb
प्रत्यागच्छति	pratyāgacchati	verb
प्रत्यागृणाति	pratyāgṛṇāti	verb
प्रत्याचष्टे	pratyācaṣṭe	verb
प्रत्यातनुते	pratyātanute	verb
प्रत्यातनोति	pratyātanoti	verb
प्रत्यादत्ते	pratyādatte	verb
प्रत्यादिशति	pratyādiśati	verb
प्रत्याद्दिशति	pratyāddiśati	verb
प्रत्यानयति	pratyānayati	verb
प्रत्यानयते	pratyānayate	verb
प्रत्यार्द्री करोति	pratyārdrī karoti	verb
प्रत्यालभते	pratyālabhate	verb
प्रत्याश्वसिति	pratyāśvasiti	verb
प्रत्याहरति	pratyāharati	verb
प्रत्याह्वयते	pratyāhvayate	verb
प्रत्युक्षति	pratyukṣati	verb
प्रत्युच्छ्रयति	pratyucchrayati	verb
प्रत्युच्छ्रयते	pratyucchrayate	verb
प्रत्युज्जीवति	pratyujjīvati	verb
प्रत्युत्तरति	pratyuttarati	verb
प्रत्युत्सीदति	pratyutsīdati	verb
प्रत्युदाहरति	pratyudāharati	verb
प्रत्युदूहति	pratyudūhati	verb
प्रत्युद्गृह्णाति	pratyudgṛhṇāti	verb
प्रत्युद्यच्छति	pratyudyacchati	verb
प्रत्युपकुरुते	pratyupakurute	verb
प्रत्युपदिशति	pratyupadiśati	verb
प्रत्युपद्रवति	pratyupadravati	verb
प्रत्युपविशति	pratyupaviśati	verb
प्रत्युपव्रजति	pratyupavrajati	verb
प्रत्युपहवते	pratyupahavate	verb
प्रत्युपाधत्ते	pratyupādhatte	verb
प्रत्युपाहरति	pratyupāharati	verb
प्रत्यूहति	pratyūhati	verb
प्रत्यूहते	pratyūhate	verb
प्रत्येति	pratyeti	verb
प्रत्रसति	pratrasati	verb
प्रददाति	pradadāti	verb
प्रदमयते	pradamayate	verb
प्रदहति	pradahati	verb
प्रदिशति	pradiśati	verb
प्रदिशते	pradiśate	verb
प्रदीधीते	pradīdhīte	verb
प्रदीप्यते	pradīpyate	verb
प्रदुष्यति	praduṣyati	verb
प्रदूयते	pradūyate	verb
प्रदृश्यते	pradṛśyate	verb
प्रदेग्धि	pradegdhi	verb
प्रद्रवति	pradravati	verb
प्रद्विष्टे	pradviṣṭe	verb
प्रद्वेष्टि	pradveṣṭi	verb
प्रधत्ते	pradhatte	verb
प्रधमति	pradhamati	verb
प्रधरति	pradharati	verb
प्रधर्षति	pradharṣati	verb
प्रधावति / -ते	pradhāvati / -te	verb
प्रधावति	pradhāvati	verb
प्रधावते	pradhāvate	verb
प्रधृष्णोति	pradhṛṣṇoti	verb
प्रध्यायति	pradhyāyati	verb
प्रध्यायते	pradhyāyate	verb
प्रध्वनति	pradhvanati	verb
प्रध्वंसते	pradhvaṃsate	verb
प्रनक्ति	pranakti	verb
प्रनवति	pranavati	verb
प्रनवते	pranavate	verb
प्रनृत्यति	pranṛtyati	verb
प्रनृत्यते	pranṛtyate	verb
प्रपचति	prapacati	verb
प्रपचते	prapacate	verb
प्रपतति	prapatati	verb
प्रपद्यते	prapadyate	verb
प्रपलायते	prapalāyate	verb
प्रपश्यति	prapaśyati	verb
प्रपिनष्टि	prapinaṣṭi	verb
प्रपिन्वति	prapinvati	verb
प्रपिन्वते	prapinvate	verb
प्रपिबति	prapibati	verb
प्रपीडयति	prapīḍayati	verb
प्रपुष्णाति	prapuṣṇāti	verb
प्रपुष्यति	prapuṣyati	verb
प्रपूजयति	prapūjayati	verb
प्रप्यायते	prapyāyate	verb
प्रप्रैति	prapraiti	verb
प्रप्रोथति	praprothati	verb
प्रप्लवते	praplavate	verb
प्रबलयति	prabalayati	verb
प्रबाधते	prabādhate	verb
प्रबुध्यते	prabudhyate	verb
प्रबोधति	prabodhati	verb
प्रब्रवीति	prabravīti	verb
प्रब्रूते	prabrūte	verb
प्रभजति	prabhajati	verb
प्रभजते	prabhajate	verb
प्रभनक्ति	prabhanakti	verb
प्रभरति	prabharati	verb
प्रभरते	prabharate	verb
प्रभवति	prabhavati	verb
प्रभाति	prabhāti	verb
प्रभाषते	prabhāṣate	verb
प्रभासते	prabhāsate	verb
प्रभिनत्ति	prabhinatti	verb
प्रभुजति	prabhujati	verb
प्रभूषति	prabhūṣati	verb
प्रभ्राजते	prabhrājate	verb
प्रभ्रंश्यते	prabhraṃśyate	verb
प्रमज्जति	pramajjati	verb
प्रमथति	pramathati	verb
प्रमथ्नाति	pramathnāti	verb
प्रमदति	pramadati	verb
प्रमन्दति	pramandati	verb
प्रमन्यते	pramanyate	verb
प्रमाणयति	pramāṇayati	verb
प्रमाणीकरोति	pramāṇīkaroti	verb
प्रमाणी करोति	pramāṇī karoti	verb
प्रमादयते	pramādayate	verb
प्रमाद्यति	pramādyati	verb
प्रमार्ष्टि	pramārṣṭi	verb
प्रमिनाति	pramināti	verb
प्रमिनुते	praminute	verb
प्रमिनोति	praminoti	verb
प्रमिमीते	pramimīte	verb
प्रमीवति	pramīvati	verb
प्रमुञ्चति / -ते	pramuñcati / -te	verb
प्रमुञ्चति	pramuñcati	verb
प्रमुञ्चते	pramuñcate	verb
प्रमुष्णाति	pramuṣṇāti	verb
प्रमुह्यति	pramuhyati	verb
प्रमूर्छति	pramūrchati	verb
प्रमृद्नाति	pramṛdnāti	verb
प्रमृशति	pramṛśati	verb
प्रमृषयति	pramṛṣayati	verb
प्रमेहति	pramehati	verb
प्रमोदते	pramodate	verb
प्रम्लानीभवति	pramlānībhavati	verb
प्रम्लायति	pramlāyati	verb
प्रयक्षति	prayakṣati	verb
प्रयक्षते	prayakṣate	verb
प्रयच्छति / -ते	prayacchati / -te	verb
प्रयच्छति	prayacchati	verb
प्रयच्छते	prayacchate	verb
प्रयजति	prayajati	verb
प्रयजते	prayajate	verb
प्रयतते	prayatate	verb
प्रयस्यति	prayasyati	verb
प्रयाचति	prayācati	verb
प्रयाचते	prayācate	verb
प्रयाति	prayāti	verb
प्रयुङ्क्ते	prayuṅkte	verb
प्रयुच्छति	prayucchati	verb
प्रयुयोति	prayuyoti	verb
प्रयौति	prayauti	verb
प्ररपति	prarapati	verb
प्ररिणाति	prariṇāti	verb
प्ररीयते	prarīyate	verb
प्ररूपयति	prarūpayati	verb
प्ररोचते	prarocate	verb
प्ररोदिति	praroditi	verb
प्ररोहति	prarohati	verb
प्रलपति	pralapati	verb
प्रलभते	pralabhate	verb
प्रलिखति	pralikhati	verb
प्रलिखते	pralikhate	verb
प्रलिम्पति	pralimpati	verb
प्रलिम्पते	pralimpate	verb
प्रलीयते	pralīyate	verb
प्रलुठति	praluṭhati	verb
प्रलुभयति	pralubhayati	verb
प्रलुभ्यति	pralubhyati	verb
प्रलुभ्यते	pralubhyate	verb
प्रलुम्पति	pralumpati	verb
प्रवक्ति	pravakti	verb
प्रवणविधेयी भवति	pravaṇavidheyī bhavati	verb
प्रवणी करोति	pravaṇī karoti	verb
प्रवणी भवति	pravaṇī bhavati	verb
प्रवदति / -ते	pravadati / -te	verb
प्रवदति	pravadati	verb
प्रवदते	pravadate	verb
प्रवनुते	pravanute	verb
प्रवपति	pravapati	verb
प्रवपते	pravapate	verb
प्रवर्णयति	pravarṇayati	verb
प्रवर्तते	pravartate	verb
प्रवर्धति	pravardhati	verb
प्रवर्धते	pravardhate	verb
प्रवल्गति	pravalgati	verb
प्रवल्गते	pravalgate	verb
प्रवल्हते	pravalhate	verb
प्रवसति	pravasati	verb
प्रवस्ते	pravaste	verb
प्रवहति	pravahati	verb
प्रवहते	pravahate	verb
प्रवाति	pravāti	verb
प्रवाशति	pravāśati	verb
प्रविकसति	pravikasati	verb
प्रविकिरति	pravikirati	verb
प्रविचरति	pravicarati	verb
प्रविचलति	pravicalati	verb
प्रविचिनोति	pravicinoti	verb
प्रविचेष्टते	praviceṣṭate	verb
प्रविजहाति	pravijahāti	verb
प्रविजानाति	pravijānāti	verb
प्रविदधाति	pravidadhāti	verb
प्रविदोग्धि	pravidogdhi	verb
प्रविधत्ते	pravidhatte	verb
प्रविध्यति	pravidhyati	verb
प्रविनश्यति	pravinaśyati	verb
प्रविन्दति	pravindati	verb
प्रविन्दते	pravindate	verb
प्रविभजति	pravibhajati	verb
प्रविभुजति	pravibhujati	verb
प्रविमुञ्चति	pravimuñcati	verb
प्रविमुञ्चते	pravimuñcate	verb
प्रविमृशति	pravimṛśati	verb
प्रविलभते	pravilabhate	verb
प्रविलम्बते	pravilambate	verb
प्रविलोकयति	pravilokayati	verb
प्रविविनक्ति	pravivinakti	verb
प्रविशति / -ते	praviśati / -te	verb
प्रविशति	praviśati	verb
प्रविशते	praviśate	verb
प्रविशालयति	praviśālayati	verb
प्रविशिनष्टि	praviśinaṣṭi	verb
प्रविस्तृणाति	pravistṛṇāti	verb
प्रवृङ्क्ते	pravṛṅkte	verb
प्रवृणक्ति	pravṛṇakti	verb
प्रवृणाति	pravṛṇāti	verb
प्रवृणिते	pravṛṇite	verb
प्रवृणुते	pravṛṇute	verb
प्रवृणोति	pravṛṇoti	verb
प्रवृश्चति	pravṛścati	verb
प्रवेति	praveti	verb
प्रवेत्ति	pravetti	verb
प्रवेपते	pravepate	verb
प्रवेरयति	praverayati	verb
प्रव्यथते	pravyathate	verb
प्रव्याहरति	pravyāharati	verb
प्रव्रजति	pravrajati	verb
प्रव्लिनाति	pravlināti	verb
प्रशब्दयति / -ति	praśabdayati / -ti	verb
प्रशाम्यति	praśāmyati	verb
प्रशास्ति	praśāsti	verb
प्रशिरयति	praśirayati	verb
प्रशुम्भते	praśumbhate	verb
प्रशोचते	praśocate	verb
प्रशोभते	praśobhate	verb
प्रशंसति	praśaṃsati	verb
प्रशंसते	praśaṃsate	verb
प्रश्चोतति	praścotati	verb
प्रश्नयति	praśnayati	verb
प्रश्नाति	praśnāti	verb
प्रश्वसिति	praśvasiti	verb
प्रसजति / -ते	prasajati / -te	verb
प्रसजति	prasajati	verb
प्रसजते	prasajate	verb
प्रसञ्चष्टे	prasañcaṣṭe	verb
प्रसते	prasate	verb
प्रसमीक्षते	prasamīkṣate	verb
प्रसमीडति	prasamīḍati	verb
प्रसरति	prasarati	verb
प्रसर्पति	prasarpati	verb
प्रसहते	prasahate	verb
प्रसाधयति	prasādhayati	verb
प्रसारयति	prasārayati	verb
प्रसिञ्चति	prasiñcati	verb
प्रसिध्यति	prasidhyati	verb
प्रसिषक्ति	prasiṣakti	verb
प्रसिसरति	prasisarati	verb
प्रसिसर्ति	prasisarti	verb
प्रसीदति	prasīdati	verb
प्रसीदते	prasīdate	verb
प्रसुवति	prasuvati	verb
प्रसूचयति	prasūcayati	verb
प्रसूते	prasūte	verb
प्रसूयते	prasūyate	verb
प्रसृजति	prasṛjati	verb
प्रसेधति	prasedhati	verb
प्रसेधते	prasedhate	verb
प्रसौति	prasauti	verb
प्रस्कन्दति	praskandati	verb
प्रस्खलति	praskhalati	verb
प्रस्तोभति	prastobhati	verb
प्रस्तौति	prastauti	verb
प्रस्नुते	prasnute	verb
प्रस्नौति	prasnauti	verb
प्रस्पन्दते	praspandate	verb
प्रस्पर्धते	praspardhate	verb
प्रस्फुरति	prasphurati	verb
प्रस्मरति	prasmarati	verb
प्रस्यन्दति	prasyandati	verb
प्रस्यन्दते	prasyandate	verb
प्रस्रवति	prasravati	verb
प्रस्रंसते	prasraṃsate	verb
प्रस्वपति	prasvapati	verb
प्रस्वपिति	prasvapiti	verb
प्रस्वरति	prasvarati	verb
प्रहन्ति	prahanti	verb
प्रहरति	praharati	verb
प्रहरति / -ते	praharati / -te	verb
प्रहरते	praharate	verb
प्रहवते	prahavate	verb
प्रहसति	prahasati	verb
प्रहिणुते	prahiṇute	verb
प्रहिणोति	prahiṇoti	verb
प्रहिण्वति	prahiṇvati	verb
प्रहिण्वते	prahiṇvate	verb
प्रहृष्यति	prahṛṣyati	verb
प्रह्लादते	prahlādate	verb
प्राणिति	prāṇiti	verb
प्राति	prāti	verb
प्रादीते	prādīte	verb
प्राद्रवति	prādravati	verb
प्राध्येति	prādhyeti	verb
प्रानिति	prāniti	verb
प्राप्नोति	prāpnoti	verb
प्रारभते	prārabhate	verb
प्रार्चति	prārcati	verb
प्रार्थयते	prārthayate	verb
प्रार्हति	prārhati	verb
प्रावति	prāvati	verb
प्रावारीयति	prāvārīyati	verb
प्रावृणुते	prāvṛṇute	verb
प्राश्नोति	prāśnoti	verb
प्रासृति	prāsṛti	verb
प्रास्ति	prāsti	verb
प्रास्यति	prāsyati	verb
प्रियायते	priyāyate	verb
प्रुष्णुते	pruṣṇute	verb
प्रुष्णोति	pruṣṇoti	verb
प्रुष्यति	pruṣyati	verb
प्रुष्वायते	pruṣvāyate	verb
प्रेक्षति / -ते	prekṣati / -te	verb
प्रेक्षते	prekṣate	verb
प्रेङ्खति	preṅkhati	verb
प्रेङ्खते	preṅkhate	verb
प्रेङ्खयति	preṅkhayati	verb
प्रेट्टे	preṭṭe	verb
प्रेयर्ति	preyarti	verb
प्रेर्ते	prerte	verb
प्रेषणं करोति	preṣaṇaṃ karoti	verb
प्रेषति	preṣati	verb
प्रेषते	preṣate	verb
प्रेषयति	preṣayati	verb
प्रेषयामि	preṣayāmi	verb
प्रेष्यति	preṣyati	verb
प्रेष्यते	preṣyate	verb
प्रैति	praiti	verb
प्रोक्षति	prokṣati	verb
प्रोचरति	procarati	verb
प्रोच्छलति	procchalati	verb
प्रोच्छ्वसिति	procchvasiti	verb
प्रोज्ज्वलति	projjvalati	verb
प्रोज्झति	projjhati	verb
प्रोञ्छति	proñchati	verb
प्रोतरति	protarati	verb
प्रोत्कण्ठयति	protkaṇṭhayati	verb
प्रोत्पतति	protpatati	verb
प्रोत्सरति	protsarati	verb
प्रोत्सहति	protsahati	verb
प्रोथति	prothati	verb
प्रोथते	prothate	verb
प्रोधरति	prodharati	verb
प्रोधरते	prodharate	verb
प्रोन्मीलति	pronmīlati	verb
प्रोर्णुते	prorṇute	verb
प्रोर्णोति	prorṇoti	verb
प्रोर्णौति	prorṇauti	verb
प्रोलिखति	prolikhati	verb
प्रोल्लसति	prollasati	verb
प्रोहति	prohati	verb
प्रौधीभवति	praudhībhavati	verb
प्लक्षति	plakṣati	verb
प्लक्षते	plakṣate	verb
प्लवते	plavate	verb
प्लायते	plāyate	verb
प्साति	psāti	verb
फक्कति	phakkati	verb
फणति	phaṇati	verb
फलति	phalati	verb
फलीकरोति	phalīkaroti	verb
फुत्करोति	phutkaroti	verb
फुत्कुरुते	phutkurute	verb
फुल्लति	phullati	verb
फूत्करोति	phūtkaroti	verb
फेनायते	phenāyate	verb
बकायति	bakāyati	verb
बधिरयति	badhirayati	verb
बधिरीकरोति	badhirīkaroti	verb
बन्धति / -ते	bandhati / -te	verb
बन्धू भवति	bandhū bhavati	verb
बन्हते	banhate	verb
बप्सति	bapsati	verb
बभस्ति	babhasti	verb
बलति	balati	verb
बलते	balate	verb
बलेन कारयति	balena kārayati	verb
बहली भवति	bahalī bhavati	verb
बहुली भवति	bahulī bhavati	verb
बाडते	bāḍate	verb
बाधति	bādhati	verb
बाधते	bādhate	verb
बाधते / -ते	bādhate / -te	verb
बालयते	bālayate	verb
बालार्कायते	bālārkāyate	verb
बाष्पायते	bāṣpāyate	verb
बिन्दति	bindati	verb
बिन्दूयते	bindūyate	verb
बिभर्ति	bibharti	verb
बिभीषति	bibhīṣati	verb
बिभृते	bibhṛte	verb
बिभेति	bibheti	verb
बीजा करोति	bījā karoti	verb
बीभत्सं करोति	bībhatsaṃ karoti	verb
बुङ्गति	buṅgati	verb
बुडति	buḍati	verb
बुध्यति / -ते	budhyati / -te	verb
बुन्धयति	bundhayati	verb
बुस्यति	busyati	verb
बेटति	beṭati	verb
बोधति / -ते	bodhati / -te	verb
बोधति	bodhati	verb
बोलयति	bolayati	verb
ब्रवीति	bravīti	verb
ब्रह्मण्यति	brahmaṇyati	verb
ब्राह्मणी भवति	brāhmaṇī bhavati	verb
ब्रूते	brūte	verb
भक्षणं करोति	bhakṣaṇaṃ karoti	verb
भक्षिवन्	bhakṣivan	verb
भङ्गुरयति	bhaṅgurayati	verb
भङ्गुरीकरोति	bhaṅgurīkaroti	verb
भजति / -ते	bhajati / -te	verb
भजति	bhajati	verb
भजते	bhajate	verb
भजनं करोति	bhajanaṃ karoti	verb
भटति	bhaṭati	verb
भटभटायते	bhaṭabhaṭāyate	verb
भण्टयति	bhaṇṭayati	verb
भण्डते	bhaṇḍate	verb
भत्सते	bhatsate	verb
भद्राकरोति	bhadrākaroti	verb
भद्रं करोति	bhadraṃ karoti	verb
भनक्ति	bhanakti	verb
भनति	bhanati	verb
भन्दते	bhandate	verb
भन्दनायते	bhandanāyate	verb
भरति	bharati	verb
भरते	bharate	verb
भर्ति	bharti	verb
भर्त्सनं करोति	bhartsanaṃ karoti	verb
भर्त्सयते	bhartsayate	verb
भर्वति	bharvati	verb
भलते	bhalate	verb
भवति	bhavati	verb
भवेत्	bhavet	verb
भषति	bhaṣati	verb
भस्माकरोति	bhasmākaroti	verb
भस्माकुरुते	bhasmākurute	verb
भस्मीकरोति	bhasmīkaroti	verb
भस्मीकुरुते	bhasmīkurute	verb
भस्मीभवति	bhasmībhavati	verb
भागं करोति	bhāgaṃ karoti	verb
भाजयते	bhājayate	verb
भाटकेन गृह्णाति	bhāṭakena gṛhṇāti	verb
भाति	bhāti	verb
भायते	bhāyate	verb
भार्गवायते	bhārgavāyate	verb
भावुक	bhāvuka	verb
भाषणं करोति	bhāṣaṇaṃ karoti	verb
भाषते	bhāṣate	verb
भासते	bhāsate	verb
भिनक्ति	bhinakti	verb
भिषक्ति	bhiṣakti	verb
भिषज्यति	bhiṣajyati	verb
भिष्णज्यति	bhiṣṇajyati	verb
भुङ्क्ते	bhuṅkte	verb
भुजति	bhujati	verb
भुण्डते	bhuṇḍate	verb
भुनक्ति	bhunakti	verb
भुरण्यति	bhuraṇyati	verb
भुरति	bhurati	verb
भुरते	bhurate	verb
भूषति	bhūṣati	verb
भृज्जति	bhṛjjati	verb
भृज्जते	bhṛjjate	verb
भृडति	bhṛḍati	verb
भोजनं करोति	bhojanaṃ karoti	verb
भ्रमति	bhramati	verb
भ्रमयति	bhramayati	verb
भ्रमरायते	bhramarāyate	verb
भ्रमायते	bhramāyate	verb
भ्राजते	bhrājate	verb
भ्राम्यति	bhrāmyati	verb
भ्रेजते	bhrejate	verb
भ्रेषति	bhreṣati	verb
भ्रेषते	bhreṣate	verb
मकरन्दकणायते	makarandakaṇāyate	verb
मक्षति	makṣati	verb
मखस्यति	makhasyati	verb
मखस्यते	makhasyate	verb
मङ्खायते	maṅkhāyate	verb
मङ्घति	maṅghati	verb
मचते	macate	verb
मज्जति	majjati	verb
मज्जनं करोति	majjanaṃ karoti	verb
मज्जयति	majjayati	verb
मञ्चते	mañcate	verb
मञ्जरयति	mañjarayati	verb
मञ्जरी करोति	mañjarī karoti	verb
मठयति	maṭhayati	verb
मडमडति	maḍamaḍati	verb
मणति	maṇati	verb
मणीयते	maṇīyate	verb
मण्ठते	maṇṭhate	verb
मण्डति	maṇḍati	verb
मण्डलायते	maṇḍalāyate	verb
मती करोति	matī karoti	verb
मद्यति / ते	madyati / te	verb
मद्यति	madyati	verb
मद्रा करोति	madrā karoti	verb
मद्रायते	madrāyate	verb
मद्रिकायते	madrikāyate	verb
मधुरयति	madhurayati	verb
मध्ये करोति	madhye karoti	verb
मननं करोति	mananaṃ karoti	verb
मनसा गमति	manasā gamati	verb
मनसा सङ्कल्पयति	manasā saṅkalpayati	verb
मनस्यति	manasyati	verb
मनस्यते	manasyate	verb
मन्तूयति	mantūyati	verb
मन्तूयते	mantūyate	verb
मन्थनं करोति	manthanaṃ karoti	verb
मन्दते	mandate	verb
मन्दयति	mandayati	verb
मन्दरायते	mandarāyate	verb
मन्दायति	mandāyati	verb
मन्दायते	mandāyate	verb
मन्दी करोति	mandī karoti	verb
मन्दी भवति	mandī bhavati	verb
मन्यति	manyati	verb
मयते	mayate	verb
मरू भवति	marū bhavati	verb
मर्चयति	marcayati	verb
मर्जयते	marjayate	verb
मर्दनं करोति	mardanaṃ karoti	verb
मर्दयति	mardayati	verb
मर्धति	mardhati	verb
मर्धते	mardhate	verb
मर्मरायते	marmarāyate	verb
मर्षति	marṣati	verb
मर्षते	marṣate	verb
मलिनयति	malinayati	verb
मलिनी करोति	malinī karoti	verb
मलिनी भवति	malinī bhavati	verb
मवते	mavate	verb
मव्यति	mavyati	verb
मष्मषा करोति	maṣmaṣā karoti	verb
मस्कते	maskate	verb
मस्यति	masyati	verb
मही करोति	mahī karoti	verb
महीयते	mahīyate	verb
माडति	māḍati	verb
माडते	māḍate	verb
माति	māti	verb
माद्यति	mādyati	verb
मानयति	mānayati	verb
मानुषी भवति	mānuṣī bhavati	verb
मायते	māyate	verb
मार्जनं करोति	mārjanaṃ karoti	verb
मार्जयति	mārjayati	verb
मार्दवी करोति	mārdavī karoti	verb
मार्ष्टि	mārṣṭi	verb
मालयति	mālayati	verb
मासी करोति	māsī karoti	verb
माहति	māhati	verb
माहते	māhate	verb
मिच्छति	micchati	verb
मिथुनायते	mithunāyate	verb
मिथुनी करोति	mithunī karoti	verb
मिथुनी भवति	mithunī bhavati	verb
मिथ्या सम्भवति	mithyā sambhavati	verb
मिमाति	mimāti	verb
मिलति / -ते	milati / -te	verb
मिलति	milati	verb
मिलते	milate	verb
मिश्रणं करोति	miśraṇaṃ karoti	verb
मिश्री करोति	miśrī karoti	verb
मिश्री भवति	miśrī bhavati	verb
मिषति	miṣati	verb
मीनाति	mīnāti	verb
मीनीते	mīnīte	verb
मीमति	mīmati	verb
मीमांसते	mīmāṃsate	verb
मीलति	mīlati	verb
मीवति	mīvati	verb
मुखरयति	mukharayati	verb
मुखरी करोति	mukharī karoti	verb
मुञ्चति	muñcati	verb
मुञ्चते	muñcate	verb
मुञ्जी करोति	muñjī karoti	verb
मुण्टति	muṇṭati	verb
मुण्डति	muṇḍati	verb
मुण्डते	muṇḍate	verb
मुण्डयति	muṇḍayati	verb
मुद्रयति	mudrayati	verb
मुद्राङ्कनं करोति	mudrāṅkanaṃ karoti	verb
मुमोच	mumoca	Perfect
मुरति	murati	verb
मुषायति	muṣāyati	verb
मुष्टी करोति	muṣṭī karoti	verb
मुष्णाति	muṣṇāti	verb
मुसली भवति	musalī bhavati	verb
मुस्तयति	mustayati	verb
मुस्यति	musyati	verb
मुह्यति	muhyati	verb
मूकी करोति	mūkī karoti	verb
मूर्छां कलयति	mūrchāṃ kalayati	verb
मूलति	mūlati	verb
मूली करोति	mūlī karoti	verb
मूल्यम् आरोपयति	mūlyam āropayati	verb
मूषति	mūṣati	verb
मृक्षति	mṛkṣati	verb
मृडति	mṛḍati	verb
मृडयति	mṛḍayati	verb
मृडयते	mṛḍayate	verb
मृड्नाति	mṛḍnāti	verb
मृणति	mṛṇati	verb
मृण्डयति	mṛṇḍayati	verb
मृद्नाति	mṛdnāti	verb
मृषायते	mṛṣāyate	verb
मृषावादं करोति	mṛṣāvādaṃ karoti	verb
मृष्यति	mṛṣyati	verb
मृष्यते	mṛṣyate	verb
मेइयति	meiyati	verb
मेघयति	meghayati	verb
मेघायते	meghāyate	verb
मेथति	methati	verb
मेथते	methate	verb
मेदते	medate	verb
मेने	mene	Perfect
मेमीयते	memīyate	verb
मेमील्ति	memīlti	verb
मेलनं करोति	melanaṃ karoti	verb
मेलयति	melayati	verb
मेलानन्दायते	melānandāyate	verb
मेषति	meṣati	verb
मेहति	mehati	verb
मोक्षते	mokṣate	verb
मोघीकरोति	moghīkaroti	verb
मोघी करोति	moghī karoti	verb
मोचते	mocate	verb
मोदते	modate	verb
मोधीकरोति	modhīkaroti	verb
मोषति	moṣati	verb
मोहम् ब्रवीति	moham bravīti	verb
म्यक्षति	myakṣati	verb
म्रक्षति	mrakṣati	verb
म्रदते	mradate	verb
म्रयति	mrayati	verb
म्रित्यति	mrityati	verb
म्रियते	mriyate	verb
म्लायति	mlāyati	verb
म्लेच्छति	mlecchati	verb
यच्छति	yacchati	verb
यजति	yajati	verb
यजते	yajate	verb
यजुष्काम्यति	yajuṣkāmyati	verb
यज्ञायति	yajñāyati	verb
यतते	yatate	verb
यथाचारम् विदधाति	yathācāram vidadhāti	verb
यथानुकूलम् विदधाति	yathānukūlam vidadhāti	verb
यथाभिमतम् विदधाति	yathābhimatam vidadhāti	verb
यथावर्गं रचयति	yathāvargaṃ racayati	verb
यन्त्रयति	yantrayati	verb
याचति	yācati	verb
याचते	yācate	verb
याति	yāti	verb
यात्रम् करोति	yātram karoti	verb
यानी करोति	yānī karoti	verb
यायते	yāyate	verb
यास्यति	yāsyati	verb
युगसहस्रायते	yugasahasrāyate	verb
युगायते	yugāyate	verb
युङ्क्ते	yuṅkte	verb
युङ्गति	yuṅgati	verb
युच्छति	yucchati	verb
युनक्ति	yunakti	verb
युनाति	yunāti	verb
युप्यति	yupyati	verb
युयोति	yuyoti	verb
यूपी करोति	yūpī karoti	verb
येषति	yeṣati	verb
येषते	yeṣate	verb
योगायते	yogāyate	verb
योजयति	yojayati	verb
यौति	yauti	verb
रक्तं मुञ्चति	raktaṃ muñcati	verb
रक्षणं करोति	rakṣaṇaṃ karoti	verb
रक्षति	rakṣati	verb
रगति	ragati	verb
रङ्घते	raṅghate	verb
रचयति	racayati	verb
रटति	raṭati	verb
रटनं करोति	raṭanaṃ karoti	verb
रणति	raṇati	verb
रथकाम्यति	rathakāmyati	verb
रथिरायति	rathirāyati	verb
रदति	radati	verb
रपति	rapati	verb
रभते	rabhate	verb
रमते	ramate	verb
रवते	ravate	verb
रवसिति	ravasiti	verb
रवीति	ravīti	verb
रशनायते	raśanāyate	verb
रसति	rasati	verb
रसयति / -ते	rasayati / -te	verb
रसयति	rasayati	verb
रहति	rahati	verb
रहायते	rahāyate	verb
रही करोति	rahī karoti	verb
रही भवति	rahī bhavati	verb
राघते	rāghate	verb
राजति	rājati	verb
राजते	rājate	verb
राजहंसायते	rājahaṃsāyate	verb
राजहंसीयति	rājahaṃsīyati	verb
राजायते	rājāyate	verb
राज्यं करोति	rājyaṃ karoti	verb
रायति	rāyati	verb
रारास्यते	rārāsyate	verb
राशीकरोति	rāśīkaroti	verb
राशीकुरुते	rāśīkurute	verb
राशीभवति	rāśībhavati	verb
रासते	rāsate	verb
रिक्ती करोति	riktī karoti	verb
रिङ्गति	riṅgati	verb
रिणाति	riṇāti	verb
रिफति	riphati	verb
रिम्पति	rimpati	verb
रिशति	riśati	verb
रिषण्यति	riṣaṇyati	verb
रीणाति	rīṇāti	verb
रीयते	rīyate	verb
रुजति	rujati	verb
रुणद्धि	ruṇaddhi	verb
रुण्टति	ruṇṭati	verb
रुण्ठति	ruṇṭhati	verb
रुन्द्धे	runddhe	verb
रुप्यति	rupyati	verb
रुवण्यति	ruvaṇyati	verb
रुशति	ruśati	verb
रुष्यति	ruṣyati	verb
रुहति	ruhati	verb
रूक्षयति	rūkṣayati	verb
रूपयति	rūpayati	verb
रूषति	rūṣati	verb
रूषयति	rūṣayati	verb
रेकते	rekate	verb
रेचति	recati	verb
रेटति	reṭati	verb
रेटते	reṭate	verb
रेवते	revate	verb
रेषते	reṣate	verb
रै करोति	rai karoti	verb
रोचते	rocate	verb
रोठति	roṭhati	verb
रोदनं करोति	rodanaṃ karoti	verb
रोदिति	roditi	verb
रोधति	rodhati	verb
रोपयति	ropayati	verb
रोषयति	roṣayati	verb
रोषितुम्	roṣitum	verb
रोषिष्यति	roṣiṣyati	verb
रोहति	rohati	verb
रोहते	rohate	verb
रौति	rauti	verb
लक्षते	lakṣate	verb
लक्षी करोति	lakṣī karoti	verb
लक्षी कुरुते	lakṣī kurute	verb
लक्षी भवति	lakṣī bhavati	verb
लगति	lagati	verb
लघयति	laghayati	verb
लघु मन्यते	laghu manyate	verb
लघू करोति	laghū karoti	verb
लघूयति	laghūyati	verb
लङ्गति	laṅgati	verb
लङ्घति / -ते	laṅghati / -te	verb
लङ्घति	laṅghati	verb
लङ्घते	laṅghate	verb
लङ्घनं करोति	laṅghanaṃ karoti	verb
लञ्जति	lañjati	verb
लञ्जयति	lañjayati	verb
लटति	laṭati	verb
लट्यति	laṭyati	verb
लडति	laḍati	verb
लपति	lapati	verb
लभते	labhate	verb
लमते	lamate	verb
लम्बते	lambate	verb
लयति	layati	verb
लर्दयति	lardayati	verb
ललति	lalati	verb
लवणयति	lavaṇayati	verb
लवलुनाति	lavalunāti	verb
लसति	lasati	verb
लहलहायते	lahalahāyate	verb
लहलहाय	lahalahāya	verb
लाजायते	lājāyate	verb
लाञ्छति	lāñchati	verb
लाति	lāti	verb
लापयते	lāpayate	verb
लालप्यते	lālapyate	verb
लालष्टि	lālaṣṭi	verb
लासिन्	lāsin	verb
लिखति	likhati	verb
लिनाति	lināti	verb
लिप्ती करोति	liptī karoti	verb
लीढे	līḍhe	verb
लीनयति	līnayati	verb
लीयते	līyate	verb
लीलायति	līlāyati	verb
लीलायते	līlāyate	verb
लुञ्चति	luñcati	verb
लुठति	luṭhati	verb
लुण्टति	luṇṭati	verb
लुनाति	lunāti	verb
लुनीते	lunīte	verb
लुभति	lubhati	verb
लुभ्यति	lubhyati	verb
लुम्बति	lumbati	verb
लूषति	lūṣati	verb
लेखनं करोति	lekhanaṃ karoti	verb
लेखागारे रक्षति	lekhāgāre rakṣati	verb
लेखायति	lekhāyati	verb
लेख्ये समारोहति	lekhye samārohati	verb
लेट्यति	leṭyati	verb
लेढि	leḍhi	verb
लेपयति	lepayati	verb
लेहनं करोति	lehanaṃ karoti	verb
लैणति	laiṇati	verb
लोकते	lokate	verb
लोचते	locate	verb
लोटति	loṭati	verb
लोटते	loṭate	verb
लोट्यति	loṭyati	verb
लोठति	loṭhati	verb
लोठते	loṭhate	verb
लोडति	loḍati	verb
लोषति	loṣati	verb
लोष्टायते	loṣṭāyate	verb
लोहति	lohati	verb
ल्पिनाति	lpināti	verb
ल्यिनाति	lyināti	verb
वक्ति	vakti	verb
वक्रगच्छति	vakragacchati	verb
वक्री भवति	vakrī bhavati	verb
वङ्गति	vaṅgati	verb
वङ्घते	vaṅghate	verb
वचनक्रमं त्यजति	vacanakramaṃ tyajati	verb
वचस्यते	vacasyate	verb
वज्रलेपायते	vajralepāyate	verb
वज्रसारी करोति	vajrasārī karoti	verb
वञ्चति	vañcati	verb
वटति	vaṭati	verb
वटयति	vaṭayati	verb
वण्टनम् करोति	vaṇṭanam karoti	verb
वण्ठते	vaṇṭhate	verb
वण्डते	vaṇḍate	verb
वदति	vadati	verb
वदते	vadate	verb
वदन्ति	vadanti	verb
वदामि	vadāmi	verb
वधम् करोति	vadham karoti	verb
वनीयति	vanīyati	verb
वनुष्यति	vanuṣyati	verb
वनुष्यते	vanuṣyate	verb
वन्दते	vandate	verb
वपति	vapati	verb
वपते	vapate	verb
वपनं करोति	vapanaṃ karoti	verb
वपुष्यति	vapuṣyati	verb
वभ्रति	vabhrati	verb
वमति	vamati	verb
वमनं करोति	vamanaṃ karoti	verb
वयति	vayati	verb
वयते	vayate	verb
वयनं करोति	vayanaṃ karoti	verb
वरिवस्यति	varivasyati	verb
वरेयति	vareyati	verb
वर्जनं करोति	varjanaṃ karoti	verb
वर्णयति	varṇayati	verb
वर्णयोजनां करोति	varṇayojanāṃ karoti	verb
वर्णी भवति	varṇī bhavati	verb
वर्तयति / -ते	vartayati / -te	verb
वर्तयति	vartayati	verb
वर्तसे	vartase	verb
वर्तामहे	vartāmahe	verb
वर्ती करोति	vartī karoti	verb
वर्तेथे	vartethe	verb
वर्धते	vardhate	verb
वर्धनं करोति	vardhanaṃ karoti	verb
वर्धयति	vardhayati	verb
वर्मयति	varmayati	verb
वर्षति	varṣati	verb
वर्षते	varṣate	verb
वर्षयति	varṣayati	verb
वर्षसहस्रायते	varṣasahasrāyate	verb
वलते	valate	verb
वलयी करोति	valayī karoti	verb
वलयी भवति	valayī bhavati	verb
वल्गति	valgati	verb
वल्गित	valgita	verb
वल्गूयति	valgūyati	verb
ववियोजयति	vaviyojayati	verb
ववृधे	vavṛdhe	Perfect
वव्रयते	vavrayate	verb
वशी कुरुते	vaśī kurute	verb
वसति	vasati	verb
वसनीय	vasanīya	verb
वसित	vasita	verb
वसितव्य	vasitavya	verb
वसेत्	vaset	verb
वस्ते	vaste	verb
वहति	vahati	verb
वहते	vahate	verb
वाचालयति	vācālayati	verb
वाजयति	vājayati	verb
वाजयते	vājayate	verb
वाजी करोति	vājī karoti	verb
वाञ्छति	vāñchati	verb
वातयति	vātayati	verb
वाति	vāti	verb
वात्यायते	vātyāyate	verb
वान्ती करोति	vāntī karoti	verb
वामी करोति	vāmī karoti	verb
वायति	vāyati	verb
वारीयते	vārīyate	verb
वार्त्तयति	vārttayati	verb
वालव्यजनी भवति	vālavyajanī bhavati	verb
वावृत्यते	vāvṛtyate	verb
वाश्यते	vāśyate	verb
वासयति	vāsayati	verb
वास्यते	vāsyate	verb
वाहते	vāhate	verb
विकत्थते	vikatthate	verb
विकम्पते	vikampate	verb
विकरोति	vikaroti	verb
विकर्षति	vikarṣati	verb
विकलयति	vikalayati	verb
विकली करोति	vikalī karoti	verb
विकल्पते	vikalpate	verb
विकसति	vikasati	verb
विकसिष्यति	vikasiṣyati	future
विकाङ्क्षति	vikāṅkṣati	verb
विकाङ्क्षते	vikāṅkṣate	verb
विकाशते	vikāśate	verb
विकासिनीलोत्पलति	vikāsinīlotpalati	verb
विकिरति	vikirati	verb
विकुरुते	vikurute	verb
विकूजति	vikūjati	verb
विकृषति	vikṛṣati	verb
विकोपयति	vikopayati	verb
विक्रमते	vikramate	verb
विक्रामति	vikrāmati	verb
विक्रीडति	vikrīḍati	verb
विक्रीणीते	vikrīṇīte	verb
विक्रोशति	vikrośati	verb
विक्लवयति	viklavayati	verb
विक्लवी करोति	viklavī karoti	verb
विक्लवी भवति	viklavī bhavati	verb
विक्षिपति	vikṣipati	verb
विक्षिपते	vikṣipate	verb
विक्षोभते	vikṣobhate	verb
विखनति	vikhanati	verb
विख्याति	vikhyāti	verb
विगणयति	vigaṇayati	verb
विगलति	vigalati	verb
विगाहते	vigāhate	verb
विग्रथ्नाति	vigrathnāti	verb
विघटते	vighaṭate	verb
विघट्टते	vighaṭṭate	verb
विघट्टयति	vighaṭṭayati	verb
विघत्ति	vighatti	verb
विघ्नयति	vighnayati	verb
विङ्क्ते	viṅkte	verb
विचति	vicati	verb
विचरति	vicarati	verb
विचलति	vicalati	verb
विचष्टे	vicaṣṭe	verb
विचालयति	vicālayati	verb
विचिकेति	viciketi	verb
विचिनुते	vicinute	verb
विचिनोति	vicinoti	verb
विचिन्तयति	vicintayati	verb
विचिन्तयते	vicintayate	verb
विचुम्बति	vicumbati	verb
विचूर्णयति	vicūrṇayati	verb
विचूर्णी भवति	vicūrṇī bhavati	verb
विचृतति	vicṛtati	verb
विचेतते	vicetate	verb
विचेष्टति	viceṣṭati	verb
विचेष्टते	viceṣṭate	verb
विच्छयति	vicchayati	verb
विच्छायति	vicchāyati	verb
विच्छाययति	vicchāyayati	verb
विछिनत्ति	vichinatti	verb
विछिन्त्ते	vichintte	verb
विजते	vijate	verb
विजनी करोति	vijanī karoti	verb
विजर्जरी करोति	vijarjarī karoti	verb
विजहाति	vijahāti	verb
विजानीते	vijānīte	verb
विजायते	vijāyate	verb
विजिघ्राति	vijighrāti	verb
विजिहीते	vijihīte	verb
विजृम्भते	vijṛmbhate	verb
विडम्बते	viḍambate	verb
विडम्बयति	viḍambayati	verb
वितत्यते	vitatyate	verb
वितथयति	vitathayati	verb
वितथी करोति	vitathī karoti	verb
वितथं करोति	vitathaṃ karoti	verb
वितनुते	vitanute	verb
वितनोति	vitanoti	verb
वितपति	vitapati	verb
वितपते	vitapate	verb
वितरणं करोति	vitaraṇaṃ karoti	verb
वितरति	vitarati	verb
वितर्कयति	vitarkayati	verb
विताडयति	vitāḍayati	verb
वितानायति	vitānāyati	verb
वितानी करोति	vitānī karoti	verb
वितानी भवति	vitānī bhavati	verb
वितिरति	vitirati	verb
वितिष्ठाते	vitiṣṭhāte	verb
वितुदति	vitudati	verb
वितुदते	vitudate	verb
वितृणत्ति	vitṛṇatti	verb
वितृप्यति	vitṛpyati	verb
वितृष्यति	vitṛṣyati	verb
वित्रिन्त्ते	vitrintte	verb
विथुर्यति	vithuryati	verb
विददाति	vidadāti	verb
विदधाति	vidadhāti	verb
विदयते	vidayate	verb
विदहति	vidahati	verb
विदारयति	vidārayati	verb
विदाशति	vidāśati	verb
विदुष्यति	viduṣyati	verb
विदूष्यति	vidūṣyati	verb
विदृणाति	vidṛṇāti	verb
विद्यति / -ते	vidyati / -te	verb
विद्यति	vidyati	verb
विद्युतयते	vidyutayate	verb
विद्योतते	vidyotate	verb
विद्योतयति	vidyotayati	verb
विद्रवति	vidravati	verb
विद्विष्टे	vidviṣṭe	verb
विद्वेष्टि	vidveṣṭi	verb
विधति	vidhati	verb
विधत्ते	vidhatte	verb
विधनी करोति	vidhanī karoti	verb
विधमति	vidhamati	verb
विधरति	vidharati	verb
विधरते	vidharate	verb
विधावति	vidhāvati	verb
विधुरयति	vidhurayati	verb
विधूनुते	vidhūnute	verb
विधूनोति	vidhūnoti	verb
विधूपायति	vidhūpāyati	verb
विध्यति	vidhyati	verb
विध्वंसते	vidhvaṃsate	verb
विनक्ति	vinakti	verb
विनदति	vinadati	verb
विनन्दति	vinandati	verb
विनन्दते	vinandate	verb
विनमति	vinamati	verb
विनमते	vinamate	verb
विनयति	vinayati	verb
विनयते	vinayate	verb
विनवते	vinavate	verb
विनशति	vinaśati	verb
विनश्यति	vinaśyati	verb
विनिकरोति	vinikaroti	verb
विनिकुरुते	vinikurute	verb
विनिकृन्तति	vinikṛntati	verb
विनिक्षिपति	vinikṣipati	verb
विनिक्षिपते	vinikṣipate	verb
विनिगृह्णाति	vinigṛhṇāti	verb
विनिन्दति	vinindati	verb1
विनिपटति	vinipaṭati	verb
विनियच्छति	viniyacchati	verb
विनियुङ्क्ते	viniyuṅkte	verb
विनिर्गच्छति	vinirgacchati	verb
विनिर्जयति	vinirjayati	verb
विनिर्दिशति	vinirdiśati	verb
विनिर्मथ्नाति	vinirmathnāti	verb
विनिर्माति	vinirmāti	verb
विनिर्मुञ्चति	vinirmuñcati	verb
विनिर्याति	viniryāti	verb
विनिर्लिखति	vinirlikhati	verb
विनिर्वर्णयति	vinirvarṇayati	verb
विनिर्वर्तते	vinirvartate	verb
विनिश्चिनोति	viniścinoti	verb
विनिश्वसिति	viniśvasiti	verb
विनिष्टनति	viniṣṭanati	verb
विनिष्पिनष्टि	viniṣpinaṣṭi	verb
विनिष्पीडयति	viniṣpīḍayati	verb
विनिहन्ति	vinihanti	verb
विनिह्नौति	vinihnauti	verb
विनिःश्वसिति	viniḥśvasiti	verb
विनिःसरति	viniḥsarati	verb
विनिःसरते	viniḥsarate	verb
विनुदति / -ते	vinudati / -te	verb
विनुदति	vinudati	verb
विनुदते	vinudate	verb
विनेदु	vinedu	Perfect
विन्दति	vindati	verb
विन्दते	vindate	verb
विन्ध्यायते	vindhyāyate	verb
विन्यस्यति	vinyasyati	verb
विपक्षयति	vipakṣayati	verb
विपक्षी करोति	vipakṣī karoti	verb
विपचति	vipacati	verb
विपञ्चयति	vipañcayati	verb
विपठति	vipaṭhati	verb
विपणति	vipaṇati	verb
विपणते	vipaṇate	verb
विपतति	vipatati	verb
विपद्यते	vipadyate	verb
विपनायति	vipanaayati	verb
विपरिक्रमते	viparikramate	verb
विपरिक्रामति	viparikrāmati	verb
विपरिजिगाति	viparijigāti	verb
विपरिद्रवति	viparidravati	verb
विपरिधत्ते	viparidhatte	verb
विपरिधावति	viparidhāvati	verb
विपरिवर्तते	viparivartate	verb
विपरिहरति	vipariharati	verb
विपरिहरते	vipariharate	verb
विपर्यस्यति	viparyasyati	verb
विपर्यस्यते	viparyasyate	verb
विपर्यासं करोति	viparyāsaṃ karoti	verb
विपल्यङ्गयते	vipalyaṅgayate	verb
विपश्यति	vipaśyati	verb
विपाटयति	vipāṭayati	verb
विपाशयति	vipāśayati	verb
विपुनाति	vipunāti	verb
विपुरी भवति	vipurī bhavati	verb
विपुलयति	vipulayati	verb
विपृच्छति	vipṛcchati	verb
विपृणक्ति	vipṛṇakti	verb
विप्रकरोति	viprakaroti	verb
विप्रचिन्तयति	vipracintayati	verb
विप्रजहाति	viprajahāti	verb
विप्रणयति	vipraṇayati	verb
विप्रतिकरोति	vipratikaroti	verb
विप्रतिपद्यते	vipratipadyate	verb
विप्रतिभाति	vipratibhāti	verb
विप्रतिष्ठते	vipratiṣṭhate	verb
विप्रद्रवति	vipradravati	verb
विप्रमुञ्चति	vipramuñcati	verb
विप्रयुनक्ति	viprayunakti	verb
विप्रलपति	vipralapati	verb
विप्रलभते	vipralabhate	verb
विप्रलुम्पति	vipralumpati	verb
विप्रलोभयते	vipralobhayate	verb
विप्रवते	vipravate	verb
विप्रवदति	vipravadati	verb
विप्रवदते	vipravadate	verb
विप्रवसति	vipravasati	verb
विप्रुष्यति	vipruṣyati	verb
विप्रैति	vipraiti	verb
विप्लवते	viplavate	verb
विफलते	viphalate	verb
विफलयति	viphalayati	verb
विफलीकरोति	viphalīkaroti	verb
विफलीकुरुते	viphalīkurute	verb
विफली भवति	viphalī bhavati	verb
विबध्नाति	vibadhnāti	verb
विबध्नीते	vibadhnīte	verb
विबाधते	vibādhate	verb
विबुध्यते	vibudhyate	verb
विबृहति	vibṛhati	verb
विब्रवीति	vibravīti	verb
विब्रूते	vibrūte	verb
विभजति	vibhajati	verb
विभजते	vibhajate	verb
विभनक्ति	vibhanakti	verb
विभरति	vibharati	verb
विभरते	vibharate	verb
विभरिभर्ति	vibharibharti	verb
विभवति	vibhavati	verb
विभागी करोति	vibhāgī karoti	verb
विभाति	vibhāti	verb
विभाषते	vibhāṣate	verb
विभासते	vibhāsate	verb
विभिनत्ति	vibhinatti	verb
विभिन्त्ते	vibhintte	verb
विभूषति	vibhūṣati	verb
विभ्रमति	vibhramati	verb
विभ्राजते	vibhrājate	verb
विभ्राम्यति	vibhrāmyati	verb
विभ्रंशते	vibhraṃśate	verb
विमथति	vimathati	verb
विमथते	vimathate	verb
विमथ्नाति	vimathnāti	verb
विमथ्नीते	vimathnīte	verb
विमनायते	vimanāyate	verb
विमन्यते	vimanyate	verb
विमयते	vimayate	verb
विमर्दति	vimardati	verb
विमर्षति	vimarṣati	verb
विमर्षते	vimarṣate	verb
विमाति	vimāti	verb
विमाद्यति	vimādyati	verb
विमार्ष्टि	vimārṣṭi	verb
विमिनुते	viminute	verb
विमिनोति	viminoti	verb
विमिमीते	vimimīte	verb
विमुखयति	vimukhayati	verb
विमुखी करोति	vimukhī karoti	verb
विमुखी भवति	vimukhī bhavati	verb
विमुञ्चति	vimuñcati	verb
विमुञ्चते	vimuñcate	verb
विमुह्यति	vimuhyati	verb
विमुह्यते	vimuhyate	verb
विमृद्नाति	vimṛdnāti	verb
विमृशति	vimṛśati	verb
विमृष्टे	vimṛṣṭe	verb
विमृष्यति	vimṛṣyati	verb
विमृष्यते	vimṛṣyate	verb
विमोहयति	vimohayati	verb
विम्रित्यति	vimrityati	verb
विम्लायति	vimlāyati	verb
विम्लायते	vimlāyate	verb
वियच्छति	viyacchati	verb
वियतते	viyatate	verb
वियाति	viyāti	verb
वियुक्तं करोति	viyuktaṃ karoti	verb
वियुङ्क्ते	viyuṅkte	verb
वियुनक्ति	viyunakti	verb
वियुयोति	viyuyoti	verb
वियौति	viyauti	verb
विरचयति	viracayati	verb
विरजी कुरुते	virajī kurute	verb
विरज्यति	virajyati	verb
विरज्यते	virajyate	verb
विरदति	viradati	verb
विरप्शते	virapśate	verb
विरमति	viramati	verb
विरलायते	viralāyate	verb
विरवति	viravati	verb
विरसति	virasati	verb
विरसी करोति	virasī karoti	verb
विरसी भवति	virasī bhavati	verb
विरहयति	virahayati	verb
विरागयति	virāgayati	verb
विराजति	virājati	verb
विराध्यति	virādhyati	verb
विरुजति	virujati	verb
विरुणद्धि	viruṇaddhi	verb
विरुन्द्धे	virunddhe	verb
विरुवति	viruvati	verb
विरोचते	virocate	verb
विरोदिति	viroditi	verb
विरोधयति	virodhayati	verb
विरोषति	viroṣati	verb
विरोहति	virohati	verb
विरौति	virauti	verb
विलक्षयति / -ते	vilakṣayati / -te	verb
विलक्षयति	vilakṣayati	verb
विलक्षयते	vilakṣayate	verb
विलङ्घति	vilaṅghati	verb
विलङ्घते	vilaṅghate	verb
विलज्जते	vilajjate	verb
विलति	vilati	verb
विलपति	vilapati	verb
विलभते	vilabhate	verb
विलम्बते	vilambate	verb
विलसति	vilasati	verb
विलिखति	vilikhati	verb
विलिम्पति	vilimpati	verb
विलिम्पते	vilimpate	verb
विलीढे	vilīḍhe	verb
विलीयते	vilīyate	verb
विलुठति	viluṭhati	verb
विलुण्ठति	viluṇṭhati	verb
विलुम्पति	vilumpati	verb
विलेढि	vileḍhi	verb
विलोकते	vilokate	verb
विवक्ति	vivakti	verb
विवदति	vivadati	verb
विवदते	vivadate	verb
विवधति	vivadhati	verb
विवयति	vivayati	verb
विवयते	vivayate	verb
विवर्तते	vivartate	verb
विवर्धते	vivardhate	verb
विवर्धयति	vivardhayati	verb
विवशी करोति	vivaśī karoti	verb
विवसति	vivasati	verb
विवस्ते	vivaste	verb
विवहति	vivahati	verb
विविच्यते	vivicyate	verb
विविनक्ति	vivinakti	verb
विवृणुते	vivṛṇute	verb
विवृणोति	vivṛṇoti	verb
विवेदति	vivedati	verb
विवेनति	vivenati	verb
विवेष्टि	viveṣṭi	verb
विव्रिश्चति	vivriścati	verb
विशङ्कते	viśaṅkate	verb
विशदी करोति	viśadī karoti	verb
विशसति	viśasati	verb
विशस्ति	viśasti	verb
विशातयति	viśātayati	verb
विशालयति	viśālayati	verb
विशिक्षति	viśikṣati	verb
विशिनष्टि	viśinaṣṭi	verb
विशिष्यते	viśiṣyate	verb
विशुध्यति	viśudhyati	verb
विशुध्यते	viśudhyate	verb
विशृणोति	viśṛṇoti	verb
विशेते	viśete	verb
विशेषणी करोति	viśeṣaṇī karoti	verb
विशंसति	viśaṃsati	verb
विश्रम्भते	viśrambhate	verb
विश्रयति	viśrayati	verb
विश्रयते	viśrayate	verb
विश्राम्यति	viśrāmyati	verb
विश्लथति	viślathati	verb
विश्लिष्यति	viśliṣyati	verb
विश्लिष्यते	viśliṣyate	verb
विश्लेषयति	viśleṣayati	verb
विश्लेषयते	viśleṣayate	verb
विश्वयति	viśvayati	verb
विश्वसति / -ते	viśvasati / -te	verb
विश्वसिति	viśvasiti	verb
विषजति	viṣajati	verb
विषहते	viṣahate	verb
विषिञ्चति	viṣiñcati	verb
विषीदति	viṣīdati	verb
विष्टभ्नोति	viṣṭabhnoti	verb
विष्टम्भ्नाति	viṣṭambhnāti	verb
विष्टवीति	viṣṭavīti	verb
विष्टौति	viṣṭauti	verb
विष्ठा	viṣṭhā	verb
विष्ठा करोति	viṣṭhā karoti	verb
विष्णाति	viṣṇāti	verb
विष्फुरति	viṣphurati	verb
विष्फुलति	viṣphulati	verb
विष्यति	viṣyati	verb
विष्यन्दते	viṣyandate	verb
विष्वणति	viṣvaṇati	verb
विसरति	visarati	verb
विसर्पति	visarpati	verb
विसिसर्ति	visisarti	verb
विसृजति	visṛjati	verb
विसंवदति	visaṃvadati	verb
विस्कभ्नाति	viskabhnāti	verb
विस्कभ्नोति	viskabhnoti	verb
विस्खलति	viskhalati	verb
विस्तनति	vistanati	verb
विस्तृणाति	vistṛṇāti	verb
विस्तृणीते	vistṛṇīte	verb
विस्तृणुते	vistṛṇute	verb
विस्तृणोति	vistṛṇoti	verb
विस्पन्दते	vispandate	verb
विस्पर्धते	vispardhate	verb
विस्फायते	visphāyate	verb
विस्फुटति	visphuṭati	verb
विस्फुरति	visphurati	verb
विस्फुलति	visphulati	verb
विस्फूर्जति	visphūrjati	verb
विस्फोटति	visphoṭati	verb
विस्मयते	vismayate	verb
विस्मरति	vismarati	verb
विस्रवति	visravati	verb
विस्रंसते	visraṃsate	verb
विस्वनति	visvanati	verb
विहन्ति	vihanti	verb
विहरति	viharati	verb
विहर्यति	viharyati	verb
विहसति	vihasati	verb
विहापयति	vihāpayati	verb
विहिनस्ति	vihinasti	verb
विहिंसति	vihiṃsati	verb
विहूर्छति	vihūrchati	verb
विहेलयते	vihelayate	verb
विह्रुणाति	vihruṇāti	verb
विह्वरति	vihvarati	verb
विह्वलति	vihvalati	verb
वीक्षते	vīkṣate	verb
वीजति	vījati	verb
वीजते	vījate	verb
वृक्षते	vṛkṣate	verb
वृणुते	vṛṇute	verb
वृणोति	vṛṇoti	verb
वृश्चति	vṛścati	verb
वृषायते	vṛṣāyate	verb
वेडति	veḍati	verb
वेति	veti	verb
वेत्ति	vetti	verb
वेदयते	vedayate	verb
वेधते	vedhate	verb
वेनति / -ते	venati / -te	verb
वेनति	venati	verb
वेपते	vepate	verb
वेलति	velati	verb
वेलयति	velayati	verb
वेल्लति	vellati	verb
वेवीते	vevīte	verb
वेश्यायत्ती करोति	veśyāyattī karoti	verb
वेष्टते	veṣṭate	verb
वेसति	vesati	verb
वेहते	vehate	verb
वेहायते	vehāyate	verb
वैतंसिकायते	vaitaṃsikāyate	verb
वैरी भवति	vairī bhavati	verb
वंशात् प्राप्नोति	vaṃśāt prāpnoti	verb
व्यग्रयति	vyagrayati	verb
व्यङ्क्ते	vyaṅkte	verb
व्यङ्गयति	vyaṅgayati	verb
व्यजति	vyajati	verb
व्यतिक्रमते	vyatikramate	verb
व्यतिक्रामति	vyatikrāmati	verb
व्यतिचरति	vyaticarati	verb
व्यतिजल्पति	vyatijalpati	verb
व्यतिपठति	vyatipaṭhati	verb
व्यतिभवते	vyatibhavate	verb
व्यतियौति	vyatiyauti	verb
व्यतिलुनीते	vyatilunīte	verb
व्यतिवर्तते	vyativartate	verb
व्यतिवहते	vyativahate	verb
व्यतिव्रजति	vyativrajati	verb
व्यतिषजति	vyatiṣajati	verb
व्यतिषजते	vyatiṣajate	verb
व्यत्ति	vyatti	verb
व्यत्यूहति	vyatyūhati	verb
व्यत्येति	vyatyeti	verb
व्यथते	vyathate	verb
व्यथयति	vyathayati	verb
व्यनक्ति	vyanakti	verb
व्यनिति	vyaniti	verb
व्यनुदधाति	vyanudadhāti	verb
व्यपकर्षति	vyapakarṣati	verb
व्यपगच्छति	vyapagacchati	verb
व्यपजहाति	vyapajahāti	verb
व्यपत्रपते	vyapatrapate	verb
व्यपदिशति	vyapadiśati	verb
व्यपनयति	vyapanayati	verb
व्यपरुणद्धि	vyaparuṇaddhi	verb
व्यपसृजति	vyapasṛjati	verb
व्यपसंसरति	vyapasaṃsarati	verb
व्यपहन्ति	vyapahanti	verb
व्यपाश्रयति	vyapāśrayati	verb
व्यपाश्रयते	vyapāśrayate	verb
व्यपेक्षते	vyapekṣate	verb
व्यपोहति	vyapohati	verb
व्यभिचरति	vyabhicarati	verb
व्ययति	vyayati	verb
व्ययते	vyayate	verb
व्ययीकरोति	vyayīkaroti	verb
व्ययीकुरुते	vyayīkurute	verb
व्यर्थयति	vyarthayati	verb
व्यर्थी करोति	vyarthī karoti	verb
व्यर्दति	vyardati	verb
व्यवकर्षति	vyavakarṣati	verb
व्यवकलयति	vyavakalayati	verb
व्यवच्छिनत्ति	vyavacchinatti	verb
व्यवदधाति	vyavadadhāti	verb
व्यवद्कत्ते	vyavadkatte	verb
व्यवधारयति	vyavadhārayati	verb
व्यवधूनुते	vyavadhūnute	verb
व्यवधूनोति	vyavadhūnoti	verb
व्यवमुञ्चति	vyavamuñcati	verb
व्यवरोहति	vyavarohati	verb
व्यवरोहते	vyavarohate	verb
व्यवलीयते	vyavalīyate	verb
व्यववेत्ति	vyavavetti	verb
व्यवव्लीनाति	vyavavlīnāti	verb
व्यवश्चोतति	vyavaścotati	verb
व्यवस्तिष्ठते	vyavastiṣṭhate	verb
व्यवस्तोभति	vyavastobhati	verb
व्यवस्थापयति	vyavasthāpayati	verb
व्यवस्यति	vyavasyati	verb
व्यवस्रवति	vyavasravati	verb
व्यवहरति / -ते	vyavaharati / -te	verb
व्यवहरति	vyavaharati	verb
व्यवहरते	vyavaharate	verb
व्यवहारयति	vyavahārayati	verb
व्यवौति	vyavauti	verb
व्यश्नाति	vyaśnāti	verb
व्यश्नीते	vyaśnīte	verb
व्यश्नुते	vyaśnute	verb
व्यश्नोति	vyaśnoti	verb
व्यसनी करोति	vyasanī karoti	verb
व्यस्यति	vyasyati	verb
व्याकरोति	vyākaroti	verb
व्याकर्षति	vyākarṣati	verb
व्याकुरुते	vyākurute	verb
व्याकुली करोति	vyākulī karoti	verb
व्याक्षिपति	vyākṣipati	verb
व्याक्षिपते	vyākṣipate	verb
व्याख्याति	vyākhyāti	verb
व्याख्यानयति	vyākhyānayati	verb
व्याचष्टे	vyācaṣṭe	verb
व्याजयति	vyājayati	verb
व्याजिघ्रति	vyājighrati	verb
व्याजी करोति	vyājī karoti	verb
व्याजृम्भते	vyājṛmbhate	verb
व्याति	vyāti	verb
व्याधायते	vyādhāyate	verb
व्याधीयते	vyādhīyate	verb
व्यानयते	vyānayate	verb
व्यापद्यते	vyāpadyate	verb
व्यापयति	vyāpayati	verb
व्यापादयति	vyāpādayati	verb
व्यापादयते	vyāpādayate	verb
व्याप्नोति	vyāpnoti	verb
व्याप्रिणुते	vyāpriṇute	verb
व्याप्रियते	vyāpriyate	verb
व्याभाषते	vyābhāṣate	verb
व्यामिश्रयति	vyāmiśrayati	verb
व्यामीलति	vyāmīlati	verb
व्यामुञ्चति	vyāmuñcati	verb
व्यामुह्यते	vyāmuhyate	verb
व्यामोहयति	vyāmohayati	verb
व्यायच्छति	vyāyacchati	verb
व्यायच्छते	vyāyacchate	verb
व्याययति	vyāyayati	verb
व्यायामं करोति	vyāyāmaṃ karoti	verb
व्यायुनक्ति	vyāyunakti	verb
व्यालिखति	vyālikhati	verb
व्यावर्णयति	vyāvarṇayati	verb
व्यावर्तते	vyāvartate	verb
व्यावल्गति	vyāvalgati	verb
व्याविध्यति	vyāvidhyati	verb
व्यासजति	vyāsajati	verb
व्याहन्ति	vyāhanti	verb
व्याहरति	vyāharati	verb
व्याहरते	vyāharate	verb
व्याह्वयते	vyāhvayate	verb
व्युक्षति	vyukṣati	verb
व्युक्षते	vyukṣate	verb
व्युचरति	vyucarati	verb
व्युचरते	vyucarate	verb
व्युच्छति	vyucchati	verb
व्युतिष्ठति	vyutiṣṭhati	verb
व्युतिष्ठते	vyutiṣṭhate	verb
व्युत्क्रामति	vyutkrāmati	verb
व्युत्पद्यते	vyutpadyate	verb
व्युत्सीदति	vyutsīdati	verb
व्युदूहति	vyudūhati	verb
व्युनत्ति	vyunatti	verb
व्युनोति	vyunoti	verb
व्युपयुङ्क्ते	vyupayuṅkte	verb
व्युपरमते	vyuparamate	verb
व्युपशम्यति	vyupaśamyati	verb
व्युषति	vyuṣati	verb
व्यूहति	vyūhati	verb
व्यूही करोति	vyūhī karoti	verb
व्येति	vyeti	verb
व्योहते	vyohate	verb
व्यंसयति	vyaṃsayati	verb
व्रज	vraja	verb
व्रजति	vrajati	verb
व्रजिष्यति	vrajiṣyati	verb
व्रतयति	vratayati	verb
व्रदते	vradate	verb
व्रुडति	vruḍati	verb
शकला करोति	śakalā karoti	verb
शकली करोति	śakalī karoti	verb
शकशकायति	śakaśakāyati	verb
शक्ति ददाति	śakti dadāti	verb
शक्यते	śakyate	verb
शङ्कते	śaṅkate	verb
शटति	śaṭati	verb
शठति	śaṭhati	verb
शठयति	śaṭhayati	verb
शतगुणी भवति	śataguṇī bhavati	verb
शतभङ्गी भवति	śatabhaṅgī bhavati	verb
शत्रूयति	śatrūyati	verb
शपतम् करोति	śapatam karoti	verb
शपतेन त्यजति	śapatena tyajati	verb
शब्दयति / -ते	śabdayati / -te	verb
शब्दयति	śabdayati	verb
शब्दायते	śabdāyate	verb
-शभते	-śabhate	verb
शमायते	śamāyate	verb
शरच्चन्द्रायते	śaraccandrāyate	verb
शरव्यायते	śaravyāyate	verb
शरशरायति	śaraśarāyati	verb
शरीरीभवति	śarīrībhavati	verb
शर्धति	śardhati	verb
शर्धते	śardhate	verb
शलभायते	śalabhāyate	verb
शल्भते	śalbhate	verb
शशविषाणायते	śaśaviṣāṇāyate	verb
शस्त्रम् पुञ्चति	śastram puñcati	verb
शस्त्रेण प्रहरति	śastreṇa praharati	verb
शहरीभवति	śaharībhavati	verb
शाठयति	śāṭhayati	verb
शाठयते	śāṭhayate	verb
शान्तयति	śāntayati	verb
शामयति	śāmayati	verb
शालभञ्जिकायते	śālabhañjikāyate	verb
शास्ति	śāsti	verb
शिक्षणम् करोति	śikṣaṇam karoti	verb
शिक्षति	śikṣati	verb
शिक्षते	śikṣate	verb
शिङ्क्ते	śiṅkte	verb
शिङ्घति	śiṅghati	verb
शिथिलयति	śithilayati	verb
शिथिलायते	śithilāyate	verb
शिथिलीकरोति	śithilīkaroti	verb
शिथिलीकुरुते	śithilīkurute	verb
शिथिलीभवति	śithilībhavati	verb
शिनष्टि	śinaṣṭi	verb
शिमिशिमायति	śimiśimāyati	verb
शिरिशिरा भवति	śiriśirā bhavati	verb
शिरिसिरायते	śirisirāyate	verb
शिरोभूषणायते	śirobhūṣaṇāyate	verb
शिरः चालयति	śiraḥ cālayati	verb
शिशत्सति	śiśatsati	verb
शिशाति	śiśāti	verb
शिशाते	śiśāte	verb
शिशिरायते	śiśirāyate	verb
शिशिरीकरोति	śiśirīkaroti	verb
शीकायति	śīkāyati	verb
शीघ्रायते	śīghrāyate	verb
शीभते	śībhate	verb
शीर्णीकरोति	śīrṇīkaroti	verb
शीलति	śīlati	verb
शीलयति	śīlayati	verb
शुक्रीभवति	śukrībhavati	verb
शुक्लीक्रोति	śuklīkroti	verb
शुच्यति	śucyati	verb
शुण्ठति	śuṇṭhati	verb
शुण्डति	śuṇḍati	verb
शुनति	śunati	verb
शुभायते	śubhāyate	verb
शुभीकरोति	śubhīkaroti	verb
शुम्भति	śumbhati	verb
शुल्कयति	śulkayati	verb
शुश्रूषते	śuśrūṣate	verb
शुश्रूषयति	śuśrūṣayati	verb
शुश्रूष्यते	śuśrūṣyate	verb
शून्यीभवति	śūnyībhavati	verb
शूषति	śūṣati	verb
शृङ्खलयति	śṛṅkhalayati	verb
शृङ्गायते	śṛṅgāyate	verb
शृणाति	śṛṇāti	verb
शृणुमः	śṛṇumaḥ	verb
शृणोमि	śṛṇomi	verb
शृण्वन्ति	śṛṇvanti	verb
शेखरयति	śekharayati	verb
शेखरायते	śekharāyate	verb
शेखरीकरोति	śekharīkaroti	verb
शेखरीभवति	śekharībhavati	verb
शेते	śete	verb
शेषति	śeṣati	verb
शैवालीयति	śaivālīyati	verb
शोचति	śocati	verb
शोठति	śoṭhati	verb
शोणति	śoṇati	verb
शोणीकरोति	śoṇīkaroti	verb
शोधयति	śodhayati	verb
शोबनं करोति	śobanaṃ karoti	verb
शोभते	śobhate	verb
शौष्कल	śauṣkala	verb
शंसति	śaṃsati	verb
श्चोतति	ścotati	verb
श्च्योतति	ścyotati	verb
श्मश्रूयते	śmaśrūyate	verb
श्मीलति	śmīlati	verb
श्यामलीकरोति	śyāmalīkaroti	verb
श्यामीकरोति	śyāmīkaroti	verb
श्यामीभवति	śyāmībhavati	verb
श्यायति	śyāyati	verb
श्यायते	śyāyate	verb
श्रङ्कते	śraṅkate	verb
श्रत्करोति	śratkaroti	verb
श्रथर्यति	śratharyati	verb
श्रम्भते	śrambhate	verb
श्रवणं करोति	śravaṇaṃ karoti	verb
श्रवस्यति	śravasyati	verb
श्रापयति	śrāpayati	verb
श्राम्यति	śrāmyati	verb
श्रावयति	śrāvayati	verb
श्रावयते	śrāvayate	verb
श्राव्यते	śrāvyate	verb
श्रीणति	śrīṇati	verb
श्रूयताम्	śrūyatām	verb
श्रूयते	śrūyate	verb
श्लक्ष्णयति	ślakṣṇayati	verb
श्लथति	ślathati	verb
श्लथायते	ślathāyate	verb
श्लथीकरोति	ślathīkaroti	verb
श्लाघते	ślāghate	verb
श्लिष्यति	śliṣyati	verb
श्लेषति	śleṣati	verb
श्वभ्रयति	śvabhrayati	verb
श्वल्कयति	śvalkayati	verb
श्वसिति	śvasiti	verb
षड्गुणीकरोति	ṣaḍguṇīkaroti	verb
सगद्गदं रोदिति	sagadgadaṃ roditi	verb
सङ्कथयति	saṅkathayati	verb
सङ्कपते	saṅkapate	verb
सङ्करीकरोति	saṅkarīkaroti	verb
सङ्कर्षति	saṅkarṣati	verb
सङ्कर्षते	saṅkarṣate	verb
सङ्कलयति	saṅkalayati	verb
सङ्कल्पते	saṅkalpate	verb
सङ्कल्पयति	saṅkalpayati	verb
सङ्कालयति	saṅkālayati	verb
सङ्कुचति	saṅkucati	verb
सङ्कृन्तति	saṅkṛntati	verb
सङ्केतयति	saṅketayati	verb
सङ्क्रमते	saṅkramate	verb
सङ्क्रामति	saṅkrāmati	verb
सङ्क्रीडते	saṅkrīḍate	verb
सङ्क्रीणाति	saṅkrīṇāti	verb
सङ्क्रीणीते	saṅkrīṇīte	verb
सङ्क्षपति	saṅkṣapati	verb
सङ्क्षमति	saṅkṣamati	verb
सङ्क्षिपति	saṅkṣipati	verb
सङ्क्षिपते	saṅkṣipate	verb
सङ्क्षोदति	saṅkṣodati	verb
सङ्क्ष्णुते	saṅkṣṇute	verb
सङ्खादति	saṅkhādati	verb
सङ्ख्याति	saṅkhyāti	verb
सङ्गच्छते	saṅgacchate	verb
सङ्गायति	saṅgāyati	verb
सङ्गाहते	saṅgāhate	verb
सङ्गुणयति	saṅguṇayati	verb
सङ्गृणाति	saṅgṛṇāti	verb
सङ्गृणीते	saṅgṛṇīte	verb
सङ्गृभायति	saṅgṛbhāyati	verb
सङ्गृह्णाति	saṅgṛhṇāti	verb
सङ्गृह्णीते	saṅgṛhṇīte	verb
सङ्घटते	saṅghaṭate	verb
सङ्घटयति	saṅghaṭayati	verb
सङ्घट्टते	saṅghaṭṭate	verb
सचते	sacate	verb
सचनस्यते	sacanasyate	verb
सजति	sajati	verb
सज्जति	sajjati	verb
सज्जयति	sajjayati	verb
सज्जी करोति	sajjī karoti	verb
सज्जीकरोति	sajjīkaroti	verb
सज्जीभवति	sajjībhavati	verb
सज्यते	sajyate	verb
सञ्चकास्ति	sañcakāsti	verb
सञ्चरति	sañcarati	verb
सञ्चलति	sañcalati	verb
सञ्चष्टे	sañcaṣṭe	verb
सञ्चित	sañcita	verb
सञ्चिनुते	sañcinute	verb
सञ्चिनोति	sañcinoti	verb
सञ्चिन्तयति	sañcintayati	verb
सञ्चीवरयते	sañcīvarayate	verb
सञ्चृतति	sañcṛtati	verb
सञ्चेतति	sañcetati	verb
सञ्चेष्टते	sañceṣṭate	verb
सञ्चोदयति	sañcodayati	verb
सञ्छिनत्ति	sañchinatti	verb
सञ्छिन्त्ते	sañchintte	verb
सञ्जति	sañjati	verb
सञ्जपति	sañjapati	verb
सञ्जरते	sañjarate	verb
सञ्जल्पति	sañjalpati	verb
सञ्जानाति	sañjānāti	verb
सञ्जानीते	sañjānīte	verb
सञ्जायते	sañjāyate	verb
सञ्जिहीते	sañjihīte	verb
सञ्जीवति	sañjīvati	verb
सञ्जृम्भते	sañjṛmbhate	verb
सञ्ज्वरति	sañjvarati	verb
सञ्ज्वलति	sañjvalati	verb
सट्टयति	saṭṭayati	verb
सत्करोति	satkaroti	verb
सत्कुरुते	satkurute	verb
सत्त्रीभवति	sattrībhavati	verb
सत्याकरोति	satyākaroti	verb
सत्यापयति	satyāpayati	verb
सत्यी करोति	satyī karoti	verb
सनति / -ते	sanati / -te	verb
सनते	sanate	verb
सनाथीकरोति	sanāthīkaroti	verb
सनायति	sanāyati	verb
सन्तक्षति	santakṣati	verb
सन्तनोति	santanoti	verb
सन्तपति	santapati	verb
सन्तम्यति	santamyati	verb
सन्तरति	santarati	verb
सन्ताडयति	santāḍayati	verb
सन्ति	santi	verb
सन्तुदति	santudati	verb
सन्तुष्यति	santuṣyati	verb
सन्तोषयति	santoṣayati	verb
सन्त्यजति	santyajati	verb
सन्त्रसति	santrasati	verb
सन्त्रस्यति	santrasyati	verb
सन्त्रायते	santrāyate	verb
सन्त्वरते	santvarate	verb
सन्दधाति	sandadhāti	verb
सन्दशति	sandaśati	verb
सन्दशस्यति	sandaśasyati	verb
सन्दहति	sandahati	verb
सन्दहते	sandahate	verb
सन्दिशति	sandiśati	verb
सन्दीप्यते	sandīpyate	verb
सन्दुग्धे	sandugdhe	verb
सन्दुष्यति	sanduṣyati	verb
सन्दृश्यते	sandṛśyate	verb
सन्देग्धि	sandegdhi	verb
सन्धत्ते	sandhatte	verb
सन्धान	sandhāna	verb
सन्धारयति	sandhārayati	verb
सन्धारयते	sandhārayate	verb
सन्धावति	sandhāvati	verb
सन्धावते	sandhāvate	verb
सन्धिं बन्धति	sandhiṃ bandhati	verb
सन्धुक्षते	sandhukṣate	verb
सपति	sapati	verb
सपत्त्राकरोति	sapattrākaroti	verb
सपर्यति	saparyati	verb
सपिण्डयति	sapiṇḍayati	verb
सफलयति	saphalayati	verb
सबार्थीभवति	sabārthībhavati	verb
सभागयति	sabhāgayati	verb
सभाजयति	sabhājayati	verb
समङ्क्ते	samaṅkte	verb
समच्छेदीकरोति	samacchedīkaroti	verb
समतिक्रमते	samatikramate	verb
समतिक्रामति	samatikrāmati	verb
समतियाति	samatiyāti	verb
समतिवर्तते	samativartate	verb
समत्ति	samatti	verb
समधिगच्छति	samadhigacchati	verb
समधितिष्ठति	samadhitiṣṭhati	verb
समधितिष्ठते	samadhitiṣṭhate	verb
समधिरोहति	samadhirohati	verb
समधिसर्पति	samadhisarpati	verb
समध्यास्ते	samadhyāste	verb
समनक्ति	samanakti	verb
समनिति	samaniti	verb
समनुकम्पते	samanukampate	verb
समनुगच्छति	samanugacchati	verb
समनुजनीते	samanujanīte	verb
समनुजानाति	samanujānāti	verb
समनुदिशति	samanudiśati	verb
समनुयुङ्ते	samanuyuṅte	verb
समनुवर्तते	samanuvartate	verb
समनुवसति	samanuvasati	verb
समनुशास्ति	samanuśāsti	verb
समनुशोचति	samanuśocati	verb
समनुस्मरति	samanusmarati	verb
समनुस्वरति	samanusvarati	verb
समन्त्रयति	samantrayati	verb
समन्विच्छति	samanvicchati	verb
समन्वीक्षते	samanvīkṣate	verb
समपावृणोति	samapāvṛṇoti	verb
समभिकीर्तयति	samabhikīrtayati	verb
समभिगर्जति	samabhigarjati	verb
समभिगूहते	samabhigūhate	verb
समभितर्जयति	samabhitarjayati	verb
समभित्यजति	samabhityajati	verb
समभिदधाति	samabhidadhāti	verb
समभिधावति	samabhidhāvati	verb
समभिधावते	samabhidhāvate	verb
समभिनन्दति	samabhinandati	verb
समभिपीडयति	samabhipīḍayati	verb
समभिपूरयति	samabhipūrayati	verb
समभिप्लवते	samabhiplavate	verb
समभियाचति	samabhiyācati	verb
समभियाचते	samabhiyācate	verb
समभिरज्यते	samabhirajyate	verb
समभिवर्तते	samabhivartate	verb
समभिवीक्षते	samabhivīkṣate	verb
समभिषिञ्चति	samabhiṣiñcati	verb
समभिष्टुते	samabhiṣṭute	verb
समभिष्टौति	samabhiṣṭauti	verb
समभ्यर्चति	samabhyarcati	verb
समभ्यर्थयते	samabhyarthayate	verb
समभ्यस्यति	samabhyasyati	verb
समभ्यादत्ते	samabhyādatte	verb
समभ्यानयति	samabhyānayati	verb
समभ्युद्धरते	samabhyuddharate	verb
समभ्येति	samabhyeti	verb
सममते	samamate	verb
समर्चति	samarcati	verb
समर्थनं करोति	samarthanaṃ karoti	verb
समर्थयते	samarthayate	verb
समलङ्करोति	samalaṅkaroti	verb
समलङ्कुरुते	samalaṅkurute	verb
समलीकरोति	samalīkaroti	verb
समवकिरति	samavakirati	verb
समवक्षिपति	samavakṣipati	verb
समवगूहते	samavagūhate	verb
समवजहाति	samavajahāti	verb
समवति	samavati	verb
समवरुणद्धि	samavaruṇaddhi	verb
समवलम्बते	samavalambate	verb
समवलीयते	samavalīyate	verb
समवलोकयति	samavalokayati	verb
समवष्टभ्नोति	samavaṣṭabhnoti	verb
समवसरति	samavasarati	verb
समवसृजति	samavasṛjati	verb
समवस्यति	samavasyati	verb
समवाप्नुते	samavāpnute	verb
समवाप्नोति	samavāpnoti	verb
समवेक्षते	samavekṣate	verb
समशंसति	samaśaṃsati	verb
समश्नाति	samaśnāti	verb
समश्नुते	samaśnute	verb
समश्नोति	samaśnoti	verb
समश्वसिति	samaśvasiti	verb
समस्ति	samasti	verb
समस्थली करोति	samasthalī karoti	verb
समस्यति	samasyati	verb
समाकर्षति	samākarṣati	verb
समाक्रन्दति	samākrandati	verb
समाक्रन्दते	samākrandate	verb
समाक्रमते	samākramate	verb
समाक्रामति	samākrāmati	verb
समाक्षिपति	samākṣipati	verb
समाक्षिपते	samākṣipate	verb
समाख्याति	samākhyāti	verb
समागच्छति	samāgacchati	verb
समाचरति	samācarati	verb
समाचष्टे	samācaṣṭe	verb
समाचिनुते	samācinute	verb
समाचिनोति	samācinoti	verb
समाच्छिनत्ति	samācchinatti	verb
समाजानाति	samājānāti	verb
समाजिघ्राति	samājighrāti	verb
समातनुते	samātanute	verb
समातनोति	samātanoti	verb
समातिष्ठति	samātiṣṭhati	verb
समातिष्ठते	samātiṣṭhate	verb
समादत्ते	samādatte	verb
समाददाति	samādadāti	verb
समादधाति	samādadhāti	verb
समादिशति	samādiśati	verb
समाधत्ते	samādhatte	verb
समाधानं करोति	samādhānaṃ karoti	verb
समानयति	samānayati	verb
समानी	samānī	verb
समापतति	samāpatati	verb
समापद्यते	samāpadyate	verb
समापनं करोति	samāpanaṃ karoti	verb
समापिबति	samāpibati	verb
समापुनाति	samāpunāti	verb
समाप्नोति	samāpnoti	verb
समाप्यायते	samāpyāyate	verb
समाप्लवते	samāplavate	verb
समाभाषते	samābhāṣate	verb
समामनति	samāmanati	verb
समामनते	samāmanate	verb
समामन्त्रयते	samāmantrayate	verb
समायच्छति	samāyacchati	verb
समायच्छते	samāyacchate	verb
समायाति	samāyāti	verb
समायुङ्क्ते	samāyuṅkte	verb
समायुनक्ति	samāyunakti	verb
समायौति	samāyauti	verb
समारोहति	samārohati	verb
समालभते	samālabhate	verb
समालम्बते	samālambate	verb
समालिखति	samālikhati	verb
समालोकयति	samālokayati	verb
समालोचयति	samālocayati	verb
समावदति	samāvadati	verb
समावर्तते	samāvartate	verb
समावसति	samāvasati	verb
समावहति	samāvahati	verb
समावहते	samāvahate	verb
समाविद्ध्यति	samāviddhyati	verb
समाविशति	samāviśati	verb
समावृणोति	samāvṛṇoti	verb
समावृनुते	samāvṛnute	verb
समाश्रयति / -ते	samāśrayati / -te	verb
समाश्रयति	samāśrayati	verb
समाश्रयते	samāśrayate	verb
समाश्वसति	samāśvasati	verb
समासजति	samāsajati	verb
समासिञ्चति	samāsiñcati	verb
समासीदति	samāsīdati	verb
समासृजति	samāsṛjati	verb
समास्तृणीते	samāstṛṇīte	verb
समास्तृणुते	samāstṛṇute	verb
समास्तृणोति	samāstṛṇoti	verb
समास्तृनाति	samāstṛnāti	verb
समास्ते	samāste	verb
समाहन्ति	samāhanti	verb
समाहरति	samāharati	verb
समाहरते	samāharate	verb
समाह्वयति	samāhvayati	verb
समाह्वयते	samāhvayate	verb
समिन्द्धे	saminddhe	verb
समिन्धे	samindhe	verb
समिन्वति	saminvati	verb
समियर्ति	samiyarti	verb
समीकरोति	samīkaroti	verb
समीकुरुते	samīkurute	verb
समीक्षते	samīkṣate	verb
समीट्टे	samīṭṭe	verb
समीर्ते	samīrte	verb
समीषते	samīṣate	verb
समुक्षति	samukṣati	verb
समुच्चरति	samuccarati	verb
समुच्छिनत्ति	samucchinatti	verb
समुच्छिन्त्ते	samucchintte	verb
समुच्छ्रयति	samucchrayati	verb
समुच्छ्रयते	samucchrayate	verb
समुच्छ्वसति	samucchvasati	verb
समुच्छ्वसिति	samucchvasiti	verb
समुज्ज्रिम्भते	samujjrimbhate	verb
समुज्ज्वलति	samujjvalati	verb
समुज्झति	samujjhati	verb
समुत्कण्ठते	samutkaṇṭhate	verb
समुत्कर्षति	samutkarṣati	verb
समुत्क्रमते	samutkramate	verb
समुत्क्रामति	samutkrāmati	verb
समुत्खनति	samutkhanati	verb
समुत्खनते	samutkhanate	verb
समुत्पतति	samutpatati	verb
समुत्पद्यते	samutpadyate	verb
समुत्पाटयति	samutpāṭayati	verb
समुत्प्लवते	samutplavate	verb
समुत्सर्पति	samutsarpati	verb
समुत्सृजति	samutsṛjati	verb
समुदाचरति	samudācarati	verb
समुदाचरते	samudācarate	verb
समुदाहरति	samudāharati	verb
समुदीक्षते	samudīkṣate	verb
समुद्घर्षति	samudgharṣati	verb
समुद्दिशति	samuddiśati	verb
समुद्द्योतते	samuddyotate	verb
समुद्धरति	samuddharati	verb
समुद्धरते	samuddharate	verb
समुद्भवति	samudbhavati	verb
समुद्यच्छति	samudyacchati	verb
समुद्रायते	samudrāyate	verb
समुद्वहति	samudvahati	verb
समुद्वहते	samudvahate	verb
समुधूनुते	samudhūnute	verb
समुधूनोति	samudhūnoti	verb
समुनत्ति	samunatti	verb
समुन्नमति	samunnamati	verb
समुन्नयति	samunnayati	verb
समुन्नयते	samunnayate	verb
समुन्मज्जति	samunmajjati	verb
समुन्मिलति	samunmilati	verb
समुन्मूलयति	samunmūlayati	verb
समुपगच्छति	samupagacchati	verb
समुपजायते	samupajāyate	verb
समुपजिघ्रति	samupajighrati	verb
समुपतिष्ठति	samupatiṣṭhati	verb
समुपतिष्ठते	samupatiṣṭhate	verb
समुपदधाति	samupadadhāti	verb
समुपद्रवति	samupadravati	verb
समुपधत्ते	samupadhatte	verb
समुपभुङ्क्ते	samupabhuṅkte	verb
समुपयाति	samupayāti	verb
समुपरुजति	samuparujati	verb
समुपरुणद्धि	samuparuṇaddhi	verb
समुपरुध्यते	samuparudhyate	verb
समुपलक्षयति	samupalakṣayati	verb
समुपलक्षयते	samupalakṣayate	verb
समुपवर्तते	samupavartate	verb
समुपवसति	samupavasati	verb
समुपविशति	samupaviśati	verb
समुपसेवते	samupasevate	verb
समुपह्वयति	samupahvayati	verb
समुपाकरोति	samupākaroti	verb
समुपाकुरुते	samupākurute	verb
समुपागच्छति	samupāgacchati	verb
समुपाचरति	samupācarati	verb
समुपादत्ते	samupādatte	verb
समुपानयति	samupānayati	verb
समुपास्ते	samupāste	verb
समुपाहरति	samupāharati	verb
समुपाहरते	samupāharate	verb
समुपैति	samupaiti	verb
समुल्लङ्घयति	samullaṅghayati	verb
समुल्लसति	samullasati	verb
समुल्लिखति	samullikhati	verb
समृचति	samṛcati	verb
समृणोति	samṛṇoti	verb
समृण्वति	samṛṇvati	verb
समृध्नोति	samṛdhnoti	verb
समृध्यति	samṛdhyati	verb
समेति	sameti	verb
समेधते	samedhate	verb
समैति	samaiti	verb
समं करोति	samaṃ karoti	verb
सम्पठति	sampaṭhati	verb
सम्पतति	sampatati	verb
सम्पद्यते	sampadyate	verb
सम्परिभवति	samparibhavati	verb
सम्परिमोदते	samparimodate	verb
सम्परिरक्षति	samparirakṣati	verb
सम्परिवर्तते	samparivartate	verb
सम्परिवृणुते	samparivṛṇute	verb
सम्परिवृणोति	samparivṛṇoti	verb
सम्परिष्वजति	sampariṣvajati	verb
सम्परिष्वजते	sampariṣvajate	verb
सम्पर्येति	samparyeti	verb
सम्पश्यति	sampaśyati	verb
सम्पश्यते	sampaśyate	verb
सम्पादयति	sampādayati	verb
सम्पिण्डयति	sampiṇḍayati	verb
सम्पिनष्टि	sampinaṣṭi	verb
सम्पीडयति	sampīḍayati	verb
सम्पृच्छति	sampṛcchati	verb
सम्पृच्छते	sampṛcchate	verb
सम्प्रकम्पते	samprakampate	verb
सम्प्रकरोति	samprakaroti	verb
सम्प्रकल्पयति	samprakalpayati	verb
सम्प्रकुरुते	samprakurute	verb
सम्प्रक्लिश्नाति	samprakliśnāti	verb
सम्प्रचरति	sampracarati	verb
सम्प्रचष्टे	sampracaṣṭe	verb
सम्प्रजनीते	samprajanīte	verb
सम्प्रजानति	samprajānati	verb
सम्प्रजायते	samprajāyate	verb
सम्प्रज्वलति	samprajvalati	verb
सम्प्रणयति	sampraṇayati	verb
सम्प्रणयते	sampraṇayate	verb
सम्प्रतर्कयति	sampratarkayati	verb
सम्प्रतिगृह्णाति	sampratigṛhṇāti	verb
सम्प्रतिग्रिह्णीते	sampratigrihṇīte	verb
सम्प्रतिजनीते	sampratijanīte	verb
सम्प्रतिजानाति	sampratijānāti	verb
सम्प्रतितिष्ठति	sampratitiṣṭhati	verb
सम्प्रतिनन्दति	sampratinandati	verb
सम्प्रतिपद्यते	sampratipadyate	verb
सम्प्रतिपूजयति	sampratipūjayati	verb
सम्प्रतिभाति	sampratibhāti	verb
सम्प्रतिशृणोति	sampratiśṛṇoti	verb
सम्प्रतीक्षते	sampratīkṣate	verb
सम्प्रतुष्यति	sampratuṣyati	verb
सम्प्रत्येति	sampratyeti	verb
सम्प्रदत्ते	sampradatte	verb
सम्प्रददाति	sampradadāti	verb
सम्प्रदिशति	sampradiśati	verb
सम्प्रदुष्यति	sampraduṣyati	verb
सम्प्रधावति	sampradhāvati	verb
सम्प्रपद्यते	samprapadyate	verb
सम्प्रबाधते	samprabādhate	verb
सम्प्रभाति	samprabhāti	verb
सम्प्रभाषते	samprabhāṣate	verb
सम्प्रमथति	sampramathati	verb
सम्प्रमथ्नाति	sampramathnāti	verb
सम्प्रमन्थति	sampramanthati	verb
सम्प्रमुञ्चति	sampramuñcati	verb
सम्प्रमुञ्चते	sampramuñcate	verb
सम्प्रमुह्यति	sampramuhyati	verb
सम्प्रमुह्यते	sampramuhyate	verb
सम्प्रमृदति	sampramṛdati	verb
सम्प्रयाचते	samprayācate	verb
सम्प्रयाति	samprayāti	verb
सम्प्रयुनक्ति	samprayunakti	verb
सम्प्रय्न्ङ्क्ते	sampraynṅkte	verb
सम्प्रवक्ति	sampravakti	verb
सम्प्रवयति	sampravayati	verb
सम्प्रवयते	sampravayate	verb
सम्प्रवर्तते	sampravartate	verb
सम्प्रवर्तयति	sampravartayati	verb
सम्प्रविशति	sampraviśati	verb
सम्प्रशास्ति	sampraśāsti	verb
सम्प्रसहति	samprasahati	verb
सम्प्रसाते	samprasāte	verb
सम्प्रसीदति	samprasīdati	verb
सम्प्रसूयते	samprasūyate	verb
सम्प्रस्पृशति	sampraspṛśati	verb
सम्प्रहरति	sampraharati	verb
सम्प्रहरते	sampraharate	verb
सम्प्राप्नोति	samprāpnoti	verb
सम्प्रार्थयति	samprārthayati	verb
सम्प्रीयते	samprīyate	verb
सम्प्रेक्षते	samprekṣate	verb
सम्प्रेषयति	sampreṣayati	verb
सम्प्रेष्यति	sampreṣyati	verb
सम्प्लवते	samplavate	verb
सम्बध्नाति	sambadhnāti	verb
सम्बाधते	sambādhate	verb
सम्बुध्यते	sambudhyate	verb
सम्बोधनम् करोति	sambodhanam karoti	verb
सम्ब्रवीति	sambravīti	verb
सम्ब्रूते	sambrūte	verb
सम्भजति	sambhajati	verb
सम्भजते	sambhajate	verb
सम्भनक्ति	sambhanakti	verb
सम्भरति	sambharati	verb
सम्भरते	sambharate	verb
सम्भवति	sambhavati	verb
सम्भवते	sambhavate	verb
सम्भाण्डयति	sambhāṇḍayati	verb
सम्भाण्डयते	sambhāṇḍayate	verb
सम्भाति	sambhāti	verb
सम्भाव्यते	sambhāvyate	verb
सम्भाषते	sambhāṣate	verb
सम्भिनत्ति	sambhinatti	verb
सम्भिन्त्ते	sambhintte	verb
सम्भुङ्क्ते	sambhuṅkte	verb
सम्भुनक्ति	sambhunakti	verb
सम्भ्रमति	sambhramati	verb
सम्भ्राजते	sambhrājate	verb
सम्भ्राम्यति	sambhrāmyati	verb
सम्भ्रंशते	sambhraṃśate	verb
सम्मदयति	sammadayati	verb
सम्मदयते	sammadayate	verb
सम्मन्दते	sammandate	verb
सम्मर्दति	sammardati	verb
सम्माति	sammāti	verb
सम्मार्जति	sammārjati	verb
सम्मार्जयति	sammārjayati	verb
सम्मार्ष्टि	sammārṣṭi	verb
सम्मिमीते	sammimīte	verb
सम्मिलति	sammilati	verb
सम्मुखीकरोति	sammukhīkaroti	verb
सम्मुह्यति	sammuhyati	verb
सम्मूर्छति	sammūrchati	verb
सम्मृजति	sammṛjati	verb
सम्मृणति	sammṛṇati	verb
सम्मृद्नाति	sammṛdnāti	verb
सम्मृशति	sammṛśati	verb
सम्मृशते	sammṛśate	verb
सम्मेलनं करोति	sammelanaṃ karoti	verb
सम्यक् कारयति	samyak kārayati	verb
सम्राजति	samrājati	verb
सम्रिच्छति	samricchati	verb
सम्विशति	samviśati	verb
सरण्यति	saraṇyati	verb
सरति	sarati	verb
सरलीकरोति	saralīkaroti	verb
सरली करोति	saralī karoti	verb
सरसरायते	sarasarāyate	verb
सरसीकरोति	sarasīkaroti	verb
सर्जति	sarjati	verb
सर्पति	sarpati	verb
सर्पिष्काम्यति	sarpiṣkāmyati	verb
सर्षपायते	sarṣapāyate	verb
सलति	salati	verb
सवति	savati	verb
सवते	savate	verb
सवर्णयति	savarṇayati	verb
सशक्तं करोति	saśaktaṃ karoti	verb
ससाद	sasāda	Perfect
सस्ति	sasti	verb
सहते	sahate	verb
सहनं करोति	sahanaṃ karoti	verb
सहसा निवर्तते	sahasā nivartate	verb
सा एकं शिरस्त्रं ग्रहीतवती	sā ekaṃ śirastraṃ grahītavatī	verb
साक्षात् करोति	sākṣāt karoti	verb
साक्षाद्भवति	sākṣādbhavati	verb
साक्षिमात्र करोति	sākṣimātra karoti	verb
साक्षीभवति	sākṣībhavati	verb
साचीकरोति	sācīkaroti	verb
सात्मीभवति	sātmībhavati	verb
सादति	sādati	verb
सादते	sādate	verb
साधयति	sādhayati	verb
साधु मन्यते	sādhu manyate	verb
साध्नोति	sādhnoti	verb
सान्त्वयति	sāntvayati	verb
सान्त्वयते	sāntvayate	verb
सायकायते	sāyakāyate	verb
सायति	sāyati	verb
सारयति	sārayati	verb
सावधानीकरोति	sāvadhānīkaroti	verb
साहाय्यं करोति	sāhāyyaṃ karoti	verb
सिञ्चति	siñcati	verb
सिञ्चते	siñcate	verb
सिद्धान्तयति	siddhāntayati	verb
सिध्यति	sidhyati	verb
सिमसिमायते	simasimāyate	verb
सिमिसिमायते	simisimāyate	verb
सिंहायते	siṃhāyate	verb
सीदति	sīdati	verb
सीमन्तयति	sīmantayati	verb
सीव्यति	sīvyati	verb
सुखाकरोति	sukhākaroti	verb
सुगन्धयति	sugandhayati	verb
सुगुप्ति करोति	sugupti karoti	verb
सुगुप्तीकरोति	suguptīkaroti	verb
सुट्टयति	suṭṭayati	verb
सुदिनायते	sudināyate	verb
सुनुते	sunute	verb
सुफलीकरोति	suphalīkaroti	verb
सुभगयति	subhagayati	verb
सुभति	subhati	verb
सुभ्नाति	subhnāti	verb
सुमखस्यते	sumakhasyate	verb
सुमनस्यते	sumanasyate	verb
सुम्नयति	sumnayati	verb
सुम्नायते	sumnāyate	verb
सुम्भति	sumbhati	verb
सुरजायते	surajāyate	verb
सुरति	surati	verb
सुरभीकरोति	surabhīkaroti	verb
सुवति	suvati	verb
सुसज्जीकरोति	susajjīkaroti	verb
सुह्यति	suhyati	verb
सूचयति	sūcayati	verb
सूचिकुलायते	sūcikulāyate	verb
सूते	sūte	verb
सूत्रयति	sūtrayati	verb
सूदते	sūdate	verb
सूर्क्ष्य्	sūrkṣy	verb
सूषति	sūṣati	verb
सृजति	sṛjati	verb
सेधति	sedhati	verb
सेवते	sevate	verb
सेविष्यति	seviṣyati	verb
सैनिकवत् प्रगच्छति	sainikavat pragacchati	verb
सैनिकवत् प्रतिष्ठति	sainikavat pratiṣṭhati	verb
सोढायते	soḍhāyate	verb
सोभति	sobhati	verb
सौन्दर्य	saundarya	verb
संगृह्णाति	saṃgṛhṇāti	verb
संचिनोति	saṃcinoti	verb
संजानीते	saṃjānīte	verb
संनदति	saṃnadati	verb
संनमति	saṃnamati	verb
संनमते	saṃnamate	verb
संनयति	saṃnayati	verb
संनर्दति	saṃnardati	verb
संनवते	saṃnavate	verb
संनसते	saṃnasate	verb
संनह्यति	saṃnahyati	verb
संनह्यते	saṃnahyate	verb
संनिगृह्णाति	saṃnigṛhṇāti	verb
संनिदधाति	saṃnidadhāti	verb
संनिधत्ते	saṃnidhatte	verb
संनिपतति	saṃnipatati	verb
संनिमज्जति	saṃnimajjati	verb
संनिर्वपति	saṃnirvapati	verb
संनिलीयते	saṃnilīyate	verb
संनिवर्तते	saṃnivartate	verb
संनिवसति	saṃnivasati	verb
संनुदति	saṃnudati	verb
संन्यस्यति	saṃnyasyati	verb
संयच्छति	saṃyacchati	verb
संयजति	saṃyajati	verb
संयजते	saṃyajate	verb
संयतते	saṃyatate	verb
संयाचते	saṃyācate	verb
संयाति	saṃyāti	verb
संयुङ्क्ते	saṃyuṅkte	verb
संयुते	saṃyute	verb
संयुध्यते	saṃyudhyate	verb
संयुनक्ति	saṃyunakti	verb
संयुनाति	saṃyunāti	verb
संयुनीते	saṃyunīte	verb
संयोपयति	saṃyopayati	verb
संयौति	saṃyauti	verb
संरक्षति	saṃrakṣati	verb
संरक्षते	saṃrakṣate	verb
संरज्यते	saṃrajyate	verb
संरभते	saṃrabhate	verb
संरमते	saṃramate	verb
संराजति	saṃrājati	verb
संरिणाति	saṃriṇāti	verb
संरिहति	saṃrihati	verb
संरुजति	saṃrujati	verb
संरुणद्धि	saṃruṇaddhi	verb
संरुन्द्धे	saṃrunddhe	verb
संरोहति	saṃrohati	verb
संरौति	saṃrauti	verb
संलक्षयति	saṃlakṣayati	verb
संलक्षयते	saṃlakṣayate	verb
संलज्जते	saṃlajjate	verb
संलपति	saṃlapati	verb
संलभते	saṃlabhate	verb
संलिखति	saṃlikhati	verb
संलेढि	saṃleḍhi	verb
संवक्ति	saṃvakti	verb
संवञ्चति	saṃvañcati	verb
संवदति	saṃvadati	verb
संवदते	saṃvadate	verb
संवन्दते	saṃvandate	verb
संवपति	saṃvapati	verb
संवपते	saṃvapate	verb
संवयति	saṃvayati	verb
संवर्णयति	saṃvarṇayati	verb
संवर्तते	saṃvartate	verb
संवर्धते	saṃvardhate	verb
संवर्धयति	saṃvardhayati	verb
संवर्धयते	saṃvardhayate	verb
संवर्मयति	saṃvarmayati	verb
संवल्गते	saṃvalgate	verb
संवसति	saṃvasati	verb
संवसते	saṃvasate	verb
संवस्ते	saṃvaste	verb
संवस्त्रयति	saṃvastrayati	verb
संवहति	saṃvahati	verb
संवहते	saṃvahate	verb
संवाश्यते	saṃvāśyate	verb
संविजते	saṃvijate	verb
संविजानाति	saṃvijānāti	verb
संविजानीते	saṃvijānīte	verb
संवित्ते	saṃvitte	verb
संविदधाति	saṃvidadhāti	verb
संविदधा	saṃvidadhā	verb3
संविद्योतते	saṃvidyotate	verb
संविधत्ते	saṃvidhatte	verb
संविध्यति	saṃvidhyati	verb
संविन्दते	saṃvindate	verb
संविभजति	saṃvibhajati	verb
संविभजते	saṃvibhajate	verb
संविभाति	saṃvibhāti	verb
संविव्यक्ति	saṃvivyakti	verb
संविशति	saṃviśati	verb
संविहरति	saṃviharati	verb
संविहसति	saṃvihasati	verb
संवीक्षते	saṃvīkṣate	verb
संवृङ्क्ते	saṃvṛṅkte	verb
संवृणुते	saṃvṛṇute	verb
संवृणोति	saṃvṛṇoti	verb
संवृत्	saṃvṛt	verb
संवेत्ति	saṃvetti	verb
संवेष्टते	saṃveṣṭate	verb
संव्यथते	saṃvyathate	verb
संशङ्कते	saṃśaṅkate	verb
संशपति	saṃśapati	verb
संशपते	saṃśapate	verb
संशब्दयति / -ति	saṃśabdayati / -ti	verb
संशम्यति	saṃśamyati	verb
संशयस्थं करोति	saṃśayasthaṃ karoti	verb
संशास्ति	saṃśāsti	verb
संशिक्षयति	saṃśikṣayati	verb
संशिङ्क्ते	saṃśiṅkte	verb
संशिशाति	saṃśiśāti	verb
संशिशीते	saṃśiśīte	verb
संशुध्यति	saṃśudhyati	verb
संशृणुते	saṃśṛṇute	verb
संशृणोति	saṃśṛṇoti	verb
संशृयाति	saṃśṛyāti	verb
संशेते	saṃśete	verb
संशोचति	saṃśocati	verb
संशोधनं करोति	saṃśodhanaṃ karoti	verb
संश्रयति	saṃśrayati	verb
संश्रयते	saṃśrayate	verb
संश्लिष्यति	saṃśliṣyati	verb
संश्लिष्यते	saṃśliṣyate	verb
संश्लोकयति	saṃślokayati	verb
संसरति	saṃsarati	verb
संसर्पति	saṃsarpati	verb
संसर्पते	saṃsarpate	verb
संसहते	saṃsahate	verb
संसाधयति	saṃsādhayati	verb
संसाधयते	saṃsādhayate	verb
संसिञ्चति	saṃsiñcati	verb
संसिञ्चते	saṃsiñcate	verb
संसिध्यति	saṃsidhyati	verb
संसीदति	saṃsīdati	verb
संसीव्यति	saṃsīvyati	verb
संसूचयति	saṃsūcayati	verb
संसृजति	saṃsṛjati	verb
संसृजते	saṃsṛjate	verb
संसेवते	saṃsevate	verb
संस्कन्दति	saṃskandati	verb
संस्करोति	saṃskaroti	verb
संस्कुरुते	saṃskurute	verb
संस्तभ्नाति	saṃstabhnāti	verb
संस्तभ्नोति	saṃstabhnoti	verb
संस्तम्भयामास	saṃstambhayāmāsa	verb
संस्तिष्ठते	saṃstiṣṭhate	verb
संस्तृणाति	saṃstṛṇāti	verb
संस्तृणीते	saṃstṛṇīte	verb
संस्तृणुते	saṃstṛṇute	verb
संस्त्रिणोति	saṃstriṇoti	verb
संस्थापयति	saṃsthāpayati	verb
संस्पन्दते	saṃspandate	verb
संस्पर्धते	saṃspardhate	verb
संस्पृहयति	saṃspṛhayati	verb
संस्फुरते	saṃsphurate	verb
संस्मयते	saṃsmayate	verb
संस्मरति	saṃsmarati	verb
संस्वजते	saṃsvajate	verb
संस्वदते	saṃsvadate	verb
संस्वरति	saṃsvarati	verb
संहन्ति	saṃhanti	verb
संहरति	saṃharati	verb
संहरते	saṃharate	verb
संहिनोति	saṃhinoti	verb
संहृष्यति	saṃhṛṣyati	verb
संह्रादते	saṃhrādate	verb
संह्वयते	saṃhvayate	verb
स्कन्दति	skandati	verb
स्कन्धयति	skandhayati	verb
स्कुनोति	skunoti	verb
स्खलति	skhalati	verb
स्तनति	stanati	verb
स्तबकयति	stabakayati	verb
स्तभ्नाति	stabhnāti	verb
स्तभ्नोति	stabhnoti	verb
स्तम्भते	stambhate	verb
स्तम्भयति	stambhayati	verb
स्तरीकरोति	starīkaroti	verb
स्तवीति	stavīti	verb
स्तायति	stāyati	verb
स्तिमितयति	stimitayati	verb
स्तुते	stute	verb
स्तुवीते	stuvīte	verb
स्तेपते	stepate	verb
स्तोभति	stobhati	verb
स्तौति	stauti	verb
स्तः	staḥ	verb
स्त्यायति	styāyati	verb
स्त्यायते	styāyate	verb
स्थगति	sthagati	verb
स्थगयति	sthagayati	verb
स्थपुटयति	sthapuṭayati	verb
स्थपुटीकरोति	sthapuṭīkaroti	verb
स्थलान्तरं प्रापयति	sthalāntaraṃ prāpayati	verb
स्थलीयति	sthalīyati	verb
स्थानं कल्पयति	sthānaṃ kalpayati	verb
स्थापयति	sthāpayati	verb
स्थायीभवति	sthāyībhavati	verb
स्थिरयति	sthirayati	verb
स्थिरीकरोति	sthirīkaroti	verb
स्थिरीभवति	sthirībhavati	verb
स्थूलयते	sthūlayate	verb
स्नानम् करोति	snānam karoti	verb
स्नायति	snāyati	verb
स्नायते	snāyate	verb
स्निह्यति	snihyati	verb
स्नुस्यति	snusyati	verb
स्नुह्यति	snuhyati	verb
स्नौति	snauti	verb
स्पन्दते	spandate	verb
स्पर्धते	spardhate	verb
स्पष्टयति	spaṣṭayati	verb
स्पष्टी करोति	spaṣṭī karoti	verb
स्पृणोति	spṛṇoti	verb
स्पृशति	spṛśati	verb
स्पृहयति	spṛhayati	verb
स्फटति	sphaṭati	verb
स्फण्डयति	sphaṇḍayati	verb
स्फलति	sphalati	verb
स्फायते	sphāyate	verb
स्फायत्कैरवति	sphāyatkairavati	verb
स्फारयति	sphārayati	verb
स्फारी भवति	sphārī bhavati	verb
स्फारीभवति	sphārībhavati	verb
स्फीतीकरोति	sphītīkaroti	verb
स्फुटबुद्बुदति	sphuṭabudbudati	verb
स्फुटी करोति	sphuṭī karoti	verb
स्फुटीकरोति	sphuṭīkaroti	verb
स्फुण्टति	sphuṇṭati	verb
स्फुरति	sphurati	verb
स्फुलति	sphulati	verb
स्फुलिङ्गायते	sphuliṅgāyate	verb
स्फूर्छति	sphūrchati	verb
स्फूर्जति	sphūrjati	verb
स्फोटयति	sphoṭayati	verb
स्मयते	smayate	verb
स्मरति	smarati	verb
स्मरवधूयति	smaravadhūyati	verb
स्मरेषुधीकरोति	smareṣudhīkaroti	verb
स्मारयति	smārayati	verb
स्यति	syati	verb
स्यन्दते	syandate	verb
स्यमति	syamati	verb
स्रवति	sravati	verb
स्रेधति	sredhati	verb
स्रंसते	sraṃsate	verb
स्रंहते	sraṃhate	verb
स्वगाकरोति	svagākaroti	verb
स्वजनयति	svajanayati	verb
स्वधयति	svadhayati	verb
स्वनति	svanati	verb
स्वपिति	svapiti	verb
स्वप्नायते	svapnāyate	verb
स्वरति	svarati	verb
स्वरयति	svarayati	verb
स्वस्थीकरोति	svasthīkaroti	verb
स्वस्थीभवति	svasthībhavati	verb
स्वादति	svādati	verb
स्वादते	svādate	verb
स्वादूकरोति	svādūkaroti	verb
स्वाध्यायति	svādhyāyati	verb
स्वानुकूलतां सम्पादयति	svānukūlatāṃ sampādayati	verb
स्वायते	svāyate	verb
स्विद्यति	svidyati	verb
स्वीकरोति	svīkaroti	verb
स्वीकुरुते	svīkurute	verb
स्वेदते	svedate	verb
हठति	haṭhati	verb
हदति	hadati	verb
हदते	hadate	verb
हन्ति	hanti	verb
हम्भायते	hambhāyate	verb
हरति	harati	verb
हरते	harate	verb
हरिणीरूपायते	hariṇīrūpāyate	verb
हर्यति	haryati	verb
हर्षति	harṣati	verb
हर्षते	harṣate	verb
हलति	halati	verb
हसति	hasati	verb
हिक्कति	hikkati	verb
हिक्कते	hikkate	verb
हितायते	hitāyate	verb
हिनोति	hinoti	verb
हिमायते	himāyate	verb
हिमीभवति	himībhavati	verb
हिलति	hilati	verb
हिळति	hiḷati	verb
हिळते	hiḷate	verb
हिंसति	hiṃsati	verb
हीडति	hīḍati	verb
हुङ्करोति	huṅkaroti	verb
हुडति	huḍati	verb
हुण्डते	huṇḍate	verb
हूर्छति	hūrchati	verb
हृणीते	hṛṇīte	verb
हेठति	heṭhati	verb
हेठते	heṭhate	verb
हेषते	heṣate	verb
हेषायते	heṣāyate	verb
होढते	hoḍhate	verb
होढायते	hoḍhāyate	verb
ह्नुते	hnute	verb
ह्मलति	hmalati	verb
ह्रसति	hrasati	verb
ह्रसते	hrasate	verb
ह्रीच्छति	hrīcchati	verb
ह्रेपयति	hrepayati	verb
ह्रेषति	hreṣati	verb
ह्रेषते	hreṣate	verb
ह्लादते	hlādate	verb
ह्वयति , ह्वयते	hvayati , hvayate	verb
ह्वयति	hvayati	verb
ह्वयते	hvayate	verb
ह्वलति	hvalati	verb
